date	dateNorm	deaths	cumDeaths	totalTweets	nonRTs	rTs	pos	neg	neu
1300399200	18/03/2011	4	4	0	0	0	0	0	0
1300485600	19/03/2011	1	5	0	0	0	0	0	0
1300572000	20/03/2011	2	7	0	0	0	0	0	0
1300658400	21/03/2011	1	8	0	0	0	0	0	0
1300744800	22/03/2011	7	15	0	0	0	0	0	0
1300831200	23/03/2011	51	66	0	0	0	0	0	0
1300917600	24/03/2011	0	66	0	0	0	0	0	0
1301004000	25/03/2011	19	85	0	0	0	0	0	0
1301090400	26/03/2011	15	100	0	0	0	0	0	0
1301176800	27/03/2011	6	106	0	0	0	0	0	0
1301259600	28/03/2011	7	113	0	0	0	0	0	0
1301346000	29/03/2011	0	113	0	0	0	0	0	0
1301432400	30/03/2011	6	119	0	0	0	0	0	0
1301518800	31/03/2011	0	119	0	0	0	0	0	0
1301605200	01/04/2011	30	149	0	0	0	0	0	0
1301691600	02/04/2011	0	149	0	0	0	0	0	0
1301778000	03/04/2011	0	149	0	0	0	0	0	0
1301864400	04/04/2011	0	149	0	0	0	0	0	0
1301950800	05/04/2011	4	153	0	0	0	0	0	0
1302037200	06/04/2011	0	153	0	0	0	0	0	0
1302123600	07/04/2011	0	153	0	0	0	0	0	0
1302210000	08/04/2011	71	224	0	0	0	0	0	0
1302296400	09/04/2011	6	230	0	0	0	0	0	0
1302382800	10/04/2011	21	251	0	0	0	0	0	0
1302469200	11/04/2011	7	258	0	0	0	0	0	0
1302555600	12/04/2011	8	266	0	0	0	0	0	0
1302642000	13/04/2011	2	268	0	0	0	0	0	0
1302728400	14/04/2011	1	269	0	0	0	0	0	0
1302814800	15/04/2011	11	280	0	0	0	0	0	0
1302901200	16/04/2011	4	284	0	0	0	0	0	0
1302987600	17/04/2011	44	328	0	0	0	0	0	0
1303074000	18/04/2011	4	332	0	0	0	0	0	0
1303160400	19/04/2011	10	342	0	0	0	0	0	0
1303246800	20/04/2011	0	342	0	0	0	0	0	0
1303333200	21/04/2011	4	346	0	0	0	0	0	0
1303419600	22/04/2011	154	500	0	0	0	0	0	0
1303506000	23/04/2011	49	549	0	0	0	0	0	0
1303592400	24/04/2011	36	585	0	0	0	0	0	0
1303678800	25/04/2011	22	607	0	0	0	0	0	0
1303765200	26/04/2011	29	636	0	0	0	0	0	0
1303851600	27/04/2011	14	650	0	0	0	0	0	0
1303938000	28/04/2011	25	675	0	0	0	0	0	0
1304024400	29/04/2011	161	836	0	0	0	0	0	0
1304110800	30/04/2011	6	842	0	0	0	0	0	0
1304197200	01/05/2011	65	907	0	0	0	0	0	0
1304283600	02/05/2011	2	909	0	0	0	0	0	0
1304370000	03/05/2011	10	919	0	0	0	0	0	0
1304456400	04/05/2011	3	922	0	0	0	0	0	0
1304542800	05/05/2011	2	924	0	0	0	0	0	0
1304629200	06/05/2011	43	967	0	0	0	0	0	0
1304715600	07/05/2011	14	981	0	0	0	0	0	0
1304802000	08/05/2011	24	1005	0	0	0	0	0	0
1304888400	09/05/2011	4	1009	0	0	0	0	0	0
1304974800	10/05/2011	17	1026	0	0	0	0	0	0
1305061200	11/05/2011	27	1053	0	0	0	0	0	0
1305147600	12/05/2011	3	1056	0	0	0	0	0	0
1305234000	13/05/2011	14	1070	0	0	0	0	0	0
1305320400	14/05/2011	9	1079	0	0	0	0	0	0
1305406800	15/05/2011	31	1110	0	0	0	0	0	0
1305493200	16/05/2011	15	1125	0	0	0	0	0	0
1305579600	17/05/2011	24	1149	0	0	0	0	0	0
1305666000	18/05/2011	26	1175	0	0	0	0	0	0
1305752400	19/05/2011	18	1193	0	0	0	0	0	0
1305838800	20/05/2011	49	1242	0	0	0	0	0	0
1305925200	21/05/2011	25	1267	0	0	0	0	0	0
1306011600	22/05/2011	10	1277	0	0	0	0	0	0
1306098000	23/05/2011	4	1281	0	0	0	0	0	0
1306184400	24/05/2011	8	1289	0	0	0	0	0	0
1306270800	25/05/2011	4	1293	0	0	0	0	0	0
1306357200	26/05/2011	3	1296	0	0	0	0	0	0
1306443600	27/05/2011	17	1313	0	0	0	0	0	0
1306530000	28/05/2011	9	1322	0	0	0	0	0	0
1306616400	29/05/2011	26	1348	0	0	0	0	0	0
1306702800	30/05/2011	12	1360	0	0	0	0	0	0
1306789200	31/05/2011	38	1398	0	0	0	0	0	0
1306875600	01/06/2011	20	1418	0	0	0	0	0	0
1306962000	02/06/2011	32	1450	0	0	0	0	0	0
1307048400	03/06/2011	84	1534	0	0	0	0	0	0
1307134800	04/06/2011	24	1558	0	0	0	0	0	0
1307221200	05/06/2011	56	1614	0	0	0	0	0	0
1307307600	06/06/2011	5	1619	0	0	0	0	0	0
1307394000	07/06/2011	0	1619	0	0	0	0	0	0
1307480400	08/06/2011	3	1622	0	0	0	0	0	0
1307566800	09/06/2011	1	1623	0	0	0	0	0	0
1307653200	10/06/2011	211	1834	0	0	0	0	0	0
1307739600	11/06/2011	3	1837	0	0	0	0	0	0
1307826000	12/06/2011	3	1840	0	0	0	0	0	0
1307912400	13/06/2011	1	1841	0	0	0	0	0	0
1307998800	14/06/2011	2	1843	0	0	0	0	0	0
1308085200	15/06/2011	4	1847	0	0	0	0	0	0
1308171600	16/06/2011	3	1850	0	0	0	0	0	0
1308258000	17/06/2011	16	1866	0	0	0	0	0	0
1308344400	18/06/2011	5	1871	0	0	0	0	0	0
1308430800	19/06/2011	1	1872	0	0	0	0	0	0
1308517200	20/06/2011	1	1873	0	0	0	0	0	0
1308603600	21/06/2011	10	1883	0	0	0	0	0	0
1308690000	22/06/2011	1	1884	0	0	0	0	0	0
1308776400	23/06/2011	2	1886	0	0	0	0	0	0
1308862800	24/06/2011	19	1905	0	0	0	0	0	0
1308949200	25/06/2011	3	1908	0	0	0	0	0	0
1309035600	26/06/2011	2	1910	0	0	0	0	0	0
1309122000	27/06/2011	2	1912	0	0	0	0	0	0
1309208400	28/06/2011	1	1913	0	0	0	0	0	0
1309294800	29/06/2011	9	1922	0	0	0	0	0	0
1309381200	30/06/2011	4	1926	0	0	0	0	0	0
1309467600	01/07/2011	29	1955	0	0	0	0	0	0
1309554000	02/07/2011	3	1958	0	0	0	0	0	0
1309640400	03/07/2011	6	1964	0	0	0	0	0	0
1309726800	04/07/2011	2	1966	0	0	0	0	0	0
1309813200	05/07/2011	29	1995	0	0	0	0	0	0
1309899600	06/07/2011	2	1997	0	0	0	0	0	0
1309986000	07/07/2011	4	2001	0	0	0	0	0	0
1310072400	08/07/2011	19	2020	0	0	0	0	0	0
1310158800	09/07/2011	2	2022	0	0	0	0	0	0
1310245200	10/07/2011	3	2025	0	0	0	0	0	0
1310331600	11/07/2011	1	2026	0	0	0	0	0	0
1310418000	12/07/2011	0	2026	0	0	0	0	0	0
1310504400	13/07/2011	7	2033	0	0	0	0	0	0
1310590800	14/07/2011	8	2041	0	0	0	0	0	0
1310677200	15/07/2011	37	2078	0	0	0	0	0	0
1310763600	16/07/2011	9	2087	0	0	0	0	0	0
1310850000	17/07/2011	11	2098	0	0	0	0	0	0
1310936400	18/07/2011	19	2117	0	0	0	0	0	0
1311022800	19/07/2011	13	2130	0	0	0	0	0	0
1311109200	20/07/2011	1	2131	0	0	0	0	0	0
1311195600	21/07/2011	6	2137	0	0	0	0	0	0
1311282000	22/07/2011	18	2155	0	0	0	0	0	0
1311368400	23/07/2011	8	2163	0	0	0	0	0	0
1311454800	24/07/2011	5	2168	0	0	0	0	0	0
1311541200	25/07/2011	6	2174	0	0	0	0	0	0
1311627600	26/07/2011	6	2180	0	0	0	0	0	0
1311714000	27/07/2011	13	2193	0	0	0	0	0	0
1311800400	28/07/2011	5	2198	0	0	0	0	0	0
1311886800	29/07/2011	22	2220	0	0	0	0	0	0
1311973200	30/07/2011	12	2232	0	0	0	0	0	0
1312059600	31/07/2011	135	2367	0	0	0	0	0	0
1312146000	01/08/2011	40	2407	0	0	0	0	0	0
1312232400	02/08/2011	11	2418	0	0	0	0	0	0
1312318800	03/08/2011	19	2437	0	0	0	0	0	0
1312405200	04/08/2011	15	2452	0	0	0	0	0	0
1312491600	05/08/2011	25	2477	0	0	0	0	0	0
1312578000	06/08/2011	6	2483	0	0	0	0	0	0
1312664400	07/08/2011	144	2627	0	0	0	0	0	0
1312750800	08/08/2011	9	2636	0	0	0	0	0	0
1312837200	09/08/2011	36	2672	0	0	0	0	0	0
1312923600	10/08/2011	19	2691	0	0	0	0	0	0
1313010000	11/08/2011	19	2710	0	0	0	0	0	0
1313096400	12/08/2011	26	2736	0	0	0	0	0	0
1313182800	13/08/2011	14	2750	0	0	0	0	0	0
1313269200	14/08/2011	42	2792	0	0	0	0	0	0
1313355600	15/08/2011	21	2813	0	0	0	0	0	0
1313442000	16/08/2011	7	2820	0	0	0	0	0	0
1313528400	17/08/2011	18	2838	0	0	0	0	0	0
1313614800	18/08/2011	11	2849	0	0	0	0	0	0
1313701200	19/08/2011	45	2894	0	0	0	0	0	0
1313787600	20/08/2011	18	2912	0	0	0	0	0	0
1313874000	21/08/2011	3	2915	0	0	0	0	0	0
1313960400	22/08/2011	37	2952	0	0	0	0	0	0
1314046800	23/08/2011	10	2962	0	0	0	0	0	0
1314133200	24/08/2011	22	2984	0	0	0	0	0	0
1314219600	25/08/2011	10	2994	0	0	0	0	0	0
1314306000	26/08/2011	15	3009	0	0	0	0	0	0
1314392400	27/08/2011	13	3022	0	0	0	0	0	0
1314478800	28/08/2011	17	3039	0	0	0	0	0	0
1314565200	29/08/2011	6	3045	0	0	0	0	0	0
1314651600	30/08/2011	10	3055	0	0	0	0	0	0
1314738000	31/08/2011	4	3059	0	0	0	0	0	0
1314824400	01/09/2011	9	3068	0	0	0	0	0	0
1314910800	02/09/2011	25	3093	0	0	0	0	0	0
1314997200	03/09/2011	8	3101	0	0	0	0	0	0
1315083600	04/09/2011	17	3118	0	0	0	0	0	0
1315170000	05/09/2011	12	3130	0	0	0	0	0	0
1315256400	06/09/2011	13	3143	0	0	0	0	0	0
1315342800	07/09/2011	48	3191	0	0	0	0	0	0
1315429200	08/09/2011	16	3207	0	0	0	0	0	0
1315515600	09/09/2011	31	3238	0	0	0	0	0	0
1315602000	10/09/2011	26	3264	0	0	0	0	0	0
1315688400	11/09/2011	17	3281	0	0	0	0	0	0
1315774800	12/09/2011	23	3304	0	0	0	0	0	0
1315861200	13/09/2011	11	3315	0	0	0	0	0	0
1315947600	14/09/2011	15	3330	0	0	0	0	0	0
1316034000	15/09/2011	15	3345	0	0	0	0	0	0
1316120400	16/09/2011	52	3397	0	0	0	0	0	0
1316206800	17/09/2011	15	3412	0	0	0	0	0	0
1316293200	18/09/2011	6	3418	0	0	0	0	0	0
1316379600	19/09/2011	14	3432	0	0	0	0	0	0
1316466000	20/09/2011	8	3440	0	0	0	0	0	0
1316552400	21/09/2011	14	3454	0	0	0	0	0	0
1316638800	22/09/2011	7	3461	0	0	0	0	0	0
1316725200	23/09/2011	27	3488	0	0	0	0	0	0
1316811600	24/09/2011	10	3498	0	0	0	0	0	0
1316898000	25/09/2011	7	3505	0	0	0	0	0	0
1316984400	26/09/2011	8	3513	0	0	0	0	0	0
1317070800	27/09/2011	14	3527	0	0	0	0	0	0
1317157200	28/09/2011	25	3552	0	0	0	0	0	0
1317243600	29/09/2011	7	3559	0	0	0	0	0	0
1317330000	30/09/2011	19	3578	0	0	0	0	0	0
1317416400	01/10/2011	16	3594	0	0	0	0	0	0
1317502800	02/10/2011	13	3607	0	0	0	0	0	0
1317589200	03/10/2011	1	3608	0	0	0	0	0	0
1317675600	04/10/2011	13	3621	0	0	0	0	0	0
1317762000	05/10/2011	18	3639	0	0	0	0	0	0
1317848400	06/10/2011	10	3649	0	0	0	0	0	0
1317934800	07/10/2011	23	3672	0	0	0	0	0	0
1318021200	08/10/2011	19	3691	0	0	0	0	0	0
1318107600	09/10/2011	18	3709	0	0	0	0	0	0
1318194000	10/10/2011	6	3715	0	0	0	0	0	0
1318280400	11/10/2011	12	3727	0	0	0	0	0	0
1318366800	12/10/2011	1	3728	0	0	0	0	0	0
1318453200	13/10/2011	15	3743	0	0	0	0	0	0
1318539600	14/10/2011	25	3768	0	0	0	0	0	0
1318626000	15/10/2011	20	3788	0	0	0	0	0	0
1318712400	16/10/2011	12	3800	0	0	0	0	0	0
1318798800	17/10/2011	40	3840	0	0	0	0	0	0
1318885200	18/10/2011	9	3849	0	0	0	0	0	0
1318971600	19/10/2011	25	3874	0	0	0	0	0	0
1319058000	20/10/2011	19	3893	0	0	0	0	0	0
1319144400	21/10/2011	28	3921	0	0	0	0	0	0
1319230800	22/10/2011	23	3944	0	0	0	0	0	0
1319317200	23/10/2011	23	3967	0	0	0	0	0	0
1319403600	24/10/2011	22	3989	0	0	0	0	0	0
1319490000	25/10/2011	3	3992	0	0	0	0	0	0
1319576400	26/10/2011	23	4015	0	0	0	0	0	0
1319662800	27/10/2011	12	4027	0	0	0	0	0	0
1319749200	28/10/2011	74	4101	0	0	0	0	0	0
1319835600	29/10/2011	27	4128	0	0	0	0	0	0
1319922000	30/10/2011	8	4136	0	0	0	0	0	0
1320012000	31/10/2011	12	4148	0	0	0	0	0	0
1320098400	01/11/2011	8	4156	0	0	0	0	0	0
1320184800	02/11/2011	25	4181	0	0	0	0	0	0
1320271200	03/11/2011	29	4210	0	0	0	0	0	0
1320357600	04/11/2011	27	4237	0	0	0	0	0	0
1320444000	05/11/2011	45	4282	0	0	0	0	0	0
1320530400	06/11/2011	29	4311	0	0	0	0	0	0
1320616800	07/11/2011	11	4322	0	0	0	0	0	0
1320703200	08/11/2011	21	4343	0	0	0	0	0	0
1320789600	09/11/2011	20	4363	0	0	0	0	0	0
1320876000	10/11/2011	38	4401	0	0	0	0	0	0
1320962400	11/11/2011	35	4436	0	0	0	0	0	0
1321048800	12/11/2011	20	4456	0	0	0	0	0	0
1321135200	13/11/2011	28	4484	0	0	0	0	0	0
1321221600	14/11/2011	40	4524	0	0	0	0	0	0
1321308000	15/11/2011	22	4546	0	0	0	0	0	0
1321394400	16/11/2011	27	4573	0	0	0	0	0	0
1321480800	17/11/2011	25	4598	0	0	0	0	0	0
1321567200	18/11/2011	25	4623	0	0	0	0	0	0
1321653600	19/11/2011	21	4644	0	0	0	0	0	0
1321740000	20/11/2011	14	4658	0	0	0	0	0	0
1321826400	21/11/2011	28	4686	0	0	0	0	0	0
1321912800	22/11/2011	39	4725	0	0	0	0	0	0
1321999200	23/11/2011	25	4750	0	0	0	0	0	0
1322085600	24/11/2011	36	4786	0	0	0	0	0	0
1322172000	25/11/2011	26	4812	0	0	0	0	0	0
1322258400	26/11/2011	38	4850	0	0	0	0	0	0
1322344800	27/11/2011	42	4892	0	0	0	0	0	0
1322431200	28/11/2011	18	4910	0	0	0	0	0	0
1322517600	29/11/2011	10	4920	0	0	0	0	0	0
1322604000	30/11/2011	28	4948	0	0	0	0	0	0
1322690400	01/12/2011	18	4966	0	0	0	0	0	0
1322776800	02/12/2011	21	4987	0	0	0	0	0	0
1322863200	03/12/2011	27	5014	0	0	0	0	0	0
1322949600	04/12/2011	34	5048	0	0	0	0	0	0
1323036000	05/12/2011	34	5082	0	0	0	0	0	0
1323122400	06/12/2011	15	5097	0	0	0	0	0	0
1323208800	07/12/2011	8	5105	0	0	0	0	0	0
1323295200	08/12/2011	30	5135	0	0	0	0	0	0
1323381600	09/12/2011	47	5182	0	0	0	0	0	0
1323468000	10/12/2011	19	5201	0	0	0	0	0	0
1323554400	11/12/2011	28	5229	0	0	0	0	0	0
1323640800	12/12/2011	21	5250	0	0	0	0	0	0
1323727200	13/12/2011	40	5290	0	0	0	0	0	0
1323813600	14/12/2011	37	5327	0	0	0	0	0	0
1323900000	15/12/2011	12	5339	0	0	0	0	0	0
1323986400	16/12/2011	19	5358	0	0	0	0	0	0
1324072800	17/12/2011	35	5393	0	0	0	0	0	0
1324159200	18/12/2011	27	5420	0	0	0	0	0	0
1324245600	19/12/2011	119	5539	0	0	0	0	0	0
1324332000	20/12/2011	144	5683	0	0	0	0	0	0
1324418400	21/12/2011	38	5721	0	0	0	0	0	0
1324504800	22/12/2011	46	5767	0	0	0	0	0	0
1324591200	23/12/2011	33	5800	0	0	0	0	0	0
1324677600	24/12/2011	31	5831	0	0	0	0	0	0
1324764000	25/12/2011	14	5845	0	0	0	0	0	0
1324850400	26/12/2011	50	5895	0	0	0	0	0	0
1324936800	27/12/2011	38	5933	0	0	0	0	0	0
1325023200	28/12/2011	26	5959	0	0	0	0	0	0
1325109600	29/12/2011	42	6001	0	0	0	0	0	0
1325196000	30/12/2011	36	6037	0	0	0	0	0	0
1325282400	31/12/2011	18	6055	0	0	0	0	0	0
1325368800	01/01/2012	14	6069	0	0	0	0	0	0
1325455200	02/01/2012	24	6093	0	0	0	0	0	0
1325541600	03/01/2012	22	6115	0	0	0	0	0	0
1325628000	04/01/2012	22	6137	0	0	0	0	0	0
1325714400	05/01/2012	32	6169	0	0	0	0	0	0
1325800800	06/01/2012	33	6202	0	0	0	0	0	0
1325887200	07/01/2012	22	6224	0	0	0	0	0	0
1325973600	08/01/2012	22	6246	0	0	0	0	0	0
1326060000	09/01/2012	18	6264	0	0	0	0	0	0
1326146400	10/01/2012	40	6304	0	0	0	0	0	0
1326232800	11/01/2012	26	6330	0	0	0	0	0	0
1326319200	12/01/2012	27	6357	0	0	0	0	0	0
1326405600	13/01/2012	17	6374	0	0	0	0	0	0
1326492000	14/01/2012	8	6382	0	0	0	0	0	0
1326578400	15/01/2012	26	6408	0	0	0	0	0	0
1326664800	16/01/2012	14	6422	0	0	0	0	0	0
1326751200	17/01/2012	33	6455	0	0	0	0	0	0
1326837600	18/01/2012	22	6477	0	0	0	0	0	0
1326924000	19/01/2012	26	6503	0	0	0	0	0	0
1327010400	20/01/2012	23	6526	0	0	0	0	0	0
1327096800	21/01/2012	103	6629	0	0	0	0	0	0
1327183200	22/01/2012	16	6645	0	0	0	0	0	0
1327269600	23/01/2012	32	6677	0	0	0	0	0	0
1327356000	24/01/2012	65	6742	0	0	0	0	0	0
1327442400	25/01/2012	22	6764	0	0	0	0	0	0
1327528800	26/01/2012	95	6859	0	0	0	0	0	0
1327615200	27/01/2012	67	6926	0	0	0	0	0	0
1327701600	28/01/2012	91	7017	0	0	0	0	0	0
1327788000	29/01/2012	111	7128	0	0	0	0	0	0
1327874400	30/01/2012	73	7201	0	0	0	0	0	0
1327960800	31/01/2012	31	7232	0	0	0	0	0	0
1328047200	01/02/2012	70	7302	0	0	0	0	0	0
1328133600	02/02/2012	24	7326	0	0	0	0	0	0
1328220000	03/02/2012	26	7352	0	0	0	0	0	0
1328306400	04/02/2012	400	7752	0	0	0	0	0	0
1328392800	05/02/2012	58	7810	0	0	0	0	0	0
1328479200	06/02/2012	88	7898	0	0	0	0	0	0
1328565600	07/02/2012	88	7986	0	0	0	0	0	0
1328652000	08/02/2012	131	8117	0	0	0	0	0	0
1328738400	09/02/2012	159	8276	0	0	0	0	0	0
1328824800	10/02/2012	109	8385	0	0	0	0	0	0
1328911200	11/02/2012	68	8453	0	0	0	0	0	0
1328997600	12/02/2012	44	8497	0	0	0	0	0	0
1329084000	13/02/2012	38	8535	0	0	0	0	0	0
1329170400	14/02/2012	57	8592	0	0	0	0	0	0
1329256800	15/02/2012	57	8649	0	0	0	0	0	0
1329343200	16/02/2012	55	8704	0	0	0	0	0	0
1329429600	17/02/2012	44	8748	0	0	0	0	0	0
1329516000	18/02/2012	22	8770	0	0	0	0	0	0
1329602400	19/02/2012	28	8798	0	0	0	0	0	0
1329688800	20/02/2012	40	8838	0	0	0	0	0	0
1329775200	21/02/2012	129	8967	0	0	0	0	0	0
1329861600	22/02/2012	110	9077	0	0	0	0	0	0
1329948000	23/02/2012	117	9194	0	0	0	0	0	0
1330034400	24/02/2012	97	9291	0	0	0	0	0	0
1330120800	25/02/2012	118	9409	0	0	0	0	0	0
1330207200	26/02/2012	68	9477	0	0	0	0	0	0
1330293600	27/02/2012	145	9622	0	0	0	0	0	0
1330380000	28/02/2012	96	9718	0	0	0	0	0	0
1330466400	29/02/2012	34	9752	0	0	0	0	0	0
1330552800	01/03/2012	73	9825	0	0	0	0	0	0
1330639200	02/03/2012	72	9897	0	0	0	0	0	0
1330725600	03/03/2012	103	10000	0	0	0	0	0	0
1330812000	04/03/2012	76	10076	0	0	0	0	0	0
1330898400	05/03/2012	24	10100	0	0	0	0	0	0
1330984800	06/03/2012	52	10152	0	0	0	0	0	0
1331071200	07/03/2012	95	10247	0	0	0	0	0	0
1331157600	08/03/2012	39	10286	0	0	0	0	0	0
1331244000	09/03/2012	102	10388	0	0	0	0	0	0
1331330400	10/03/2012	109	10497	0	0	0	0	0	0
1331416800	11/03/2012	159	10656	0	0	0	0	0	0
1331503200	12/03/2012	168	10824	0	0	0	0	0	0
1331589600	13/03/2012	121	10945	0	0	0	0	0	0
1331676000	14/03/2012	120	11065	0	0	0	0	0	0
1331762400	15/03/2012	72	11137	0	0	0	0	0	0
1331848800	16/03/2012	32	11169	0	0	0	0	0	0
1331935200	17/03/2012	40	11209	0	0	0	0	0	0
1332021600	18/03/2012	47	11256	0	0	0	0	0	0
1332108000	19/03/2012	104	11360	0	0	0	0	0	0
1332194400	20/03/2012	69	11429	0	0	0	0	0	0
1332280800	21/03/2012	84	11513	0	0	0	0	0	0
1332367200	22/03/2012	98	11611	0	0	0	0	0	0
1332453600	23/03/2012	55	11666	0	0	0	0	0	0
1332540000	24/03/2012	54	11720	0	0	0	0	0	0
1332626400	25/03/2012	56	11776	0	0	0	0	0	0
1332709200	26/03/2012	63	11839	0	0	0	0	0	0
1332795600	27/03/2012	61	11900	0	0	0	0	0	0
1332882000	28/03/2012	34	11934	0	0	0	0	0	0
1332968400	29/03/2012	45	11979	0	0	0	0	0	0
1333054800	30/03/2012	65	12044	0	0	0	0	0	0
1333141200	31/03/2012	62	12106	0	0	0	0	0	0
1333227600	01/04/2012	81	12187	0	0	0	0	0	0
1333314000	02/04/2012	123	12310	0	0	0	0	0	0
1333400400	03/04/2012	67	12377	0	0	0	0	0	0
1333486800	04/04/2012	134	12511	0	0	0	0	0	0
1333573200	05/04/2012	77	12588	0	0	0	0	0	0
1333659600	06/04/2012	48	12636	0	0	0	0	0	0
1333746000	07/04/2012	182	12818	0	0	0	0	0	0
1333832400	08/04/2012	77	12895	0	0	0	0	0	0
1333918800	09/04/2012	259	13154	0	0	0	0	0	0
1334005200	10/04/2012	130	13284	0	0	0	0	0	0
1334091600	11/04/2012	47	13331	0	0	0	0	0	0
1334178000	12/04/2012	23	13354	0	0	0	0	0	0
1334264400	13/04/2012	17	13371	0	0	0	0	0	0
1334350800	14/04/2012	24	13395	0	0	0	0	0	0
1334437200	15/04/2012	24	13419	0	0	0	0	0	0
1334523600	16/04/2012	76	13495	0	0	0	0	0	0
1334610000	17/04/2012	38	13533	0	0	0	0	0	0
1334696400	18/04/2012	36	13569	0	0	0	0	0	0
1334782800	19/04/2012	27	13596	0	0	0	0	0	0
1334869200	20/04/2012	59	13655	0	0	0	0	0	0
1334955600	21/04/2012	27	13682	0	0	0	0	0	0
1335042000	22/04/2012	26	13708	0	0	0	0	0	0
1335128400	23/04/2012	70	13778	0	0	0	0	0	0
1335214800	24/04/2012	38	13816	0	0	0	0	0	0
1335301200	25/04/2012	75	13891	0	0	0	0	0	0
1335387600	26/04/2012	73	13964	0	0	0	0	0	0
1335474000	27/04/2012	32	13996	0	0	0	0	0	0
1335560400	28/04/2012	37	14033	0	0	0	0	0	0
1335646800	29/04/2012	32	14065	0	0	0	0	0	0
1335733200	30/04/2012	18	14083	0	0	0	0	0	0
1335819600	01/05/2012	48	14131	0	0	0	0	0	0
1335906000	02/05/2012	34	14165	0	0	0	0	0	0
1335992400	03/05/2012	32	14197	0	0	0	0	0	0
1336078800	04/05/2012	45	14242	0	0	0	0	0	0
1336165200	05/05/2012	22	14264	0	0	0	0	0	0
1336251600	06/05/2012	16	14280	0	0	0	0	0	0
1336338000	07/05/2012	36	14316	0	0	0	0	0	0
1336424400	08/05/2012	24	14340	0	0	0	0	0	0
1336510800	09/05/2012	27	14367	0	0	0	0	0	0
1336597200	10/05/2012	51	14418	0	0	0	0	0	0
1336683600	11/05/2012	18	14436	0	0	0	0	0	0
1336770000	12/05/2012	31	14467	0	0	0	0	0	0
1336856400	13/05/2012	36	14503	0	0	0	0	0	0
1336942800	14/05/2012	22	14525	0	0	0	0	0	0
1337029200	15/05/2012	108	14633	0	0	0	0	0	0
1337115600	16/05/2012	26	14659	0	0	0	0	0	0
1337202000	17/05/2012	39	14698	0	0	0	0	0	0
1337288400	18/05/2012	27	14725	0	0	0	0	0	0
1337374800	19/05/2012	33	14758	0	0	0	0	0	0
1337461200	20/05/2012	79	14837	0	0	0	0	0	0
1337547600	21/05/2012	37	14874	0	0	0	0	0	0
1337634000	22/05/2012	35	14909	0	0	0	0	0	0
1337720400	23/05/2012	32	14941	0	0	0	0	0	0
1337806800	24/05/2012	42	14983	0	0	0	0	0	0
1337893200	25/05/2012	155	15138	0	0	0	0	0	0
1337979600	26/05/2012	64	15202	0	0	0	0	0	0
1338066000	27/05/2012	80	15282	0	0	0	0	0	0
1338152400	28/05/2012	44	15326	0	0	0	0	0	0
1338238800	29/05/2012	81	15407	0	0	0	0	0	0
1338325200	30/05/2012	45	15452	0	0	0	0	0	0
1338411600	31/05/2012	68	15520	0	0	0	0	0	0
1338498000	01/06/2012	61	15581	0	0	0	0	0	0
1338584400	02/06/2012	41	15622	0	0	0	0	0	0
1338670800	03/06/2012	46	15668	0	0	0	0	0	0
1338757200	04/06/2012	39	15707	0	0	0	0	0	0
1338843600	05/06/2012	57	15764	0	0	0	0	0	0
1338930000	06/06/2012	136	15900	0	0	0	0	0	0
1339016400	07/06/2012	54	15954	0	0	0	0	0	0
1339102800	08/06/2012	50	16004	0	0	0	0	0	0
1339189200	09/06/2012	98	16102	0	0	0	0	0	0
1339275600	10/06/2012	57	16159	0	0	0	0	0	0
1339362000	11/06/2012	141	16300	0	0	0	0	0	0
1339448400	12/06/2012	80	16380	0	0	0	0	0	0
1339534800	13/06/2012	83	16463	0	0	0	0	0	0
1339621200	14/06/2012	77	16540	0	0	0	0	0	0
1339707600	15/06/2012	54	16594	0	0	0	0	0	0
1339794000	16/06/2012	89	16683	0	0	0	0	0	0
1339880400	17/06/2012	72	16755	0	0	0	0	0	0
1339966800	18/06/2012	88	16843	0	0	0	0	0	0
1340053200	19/06/2012	58	16901	0	0	0	0	0	0
1340139600	20/06/2012	68	16969	0	0	0	0	0	0
1340226000	21/06/2012	135	17104	0	0	0	0	0	0
1340312400	22/06/2012	84	17188	0	0	0	0	0	0
1340398800	23/06/2012	105	17293	0	0	0	0	0	0
1340485200	24/06/2012	95	17388	0	0	0	0	0	0
1340571600	25/06/2012	95	17483	0	0	0	0	0	0
1340658000	26/06/2012	139	17622	0	0	0	0	0	0
1340744400	27/06/2012	113	17735	0	0	0	0	0	0
1340830800	28/06/2012	170	17905	0	0	0	0	0	0
1340917200	29/06/2012	88	17993	0	0	0	0	0	0
1341003600	30/06/2012	190	18183	0	0	0	0	0	0
1341090000	01/07/2012	100	18283	0	0	0	0	0	0
1341176400	02/07/2012	113	18396	0	0	0	0	0	0
1341262800	03/07/2012	82	18478	0	0	0	0	0	0
1341349200	04/07/2012	82	18560	0	0	0	0	0	0
1341435600	05/07/2012	82	18642	0	0	0	0	0	0
1341522000	06/07/2012	97	18739	0	0	0	0	0	0
1341608400	07/07/2012	70	18809	0	0	0	0	0	0
1341694800	08/07/2012	66	18875	0	0	0	0	0	0
1341781200	09/07/2012	94	18969	0	0	0	0	0	0
1341867600	10/07/2012	70	19039	0	0	0	0	0	0
1341954000	11/07/2012	66	19105	0	0	0	0	0	0
1342040400	12/07/2012	297	19402	0	0	0	0	0	0
1342126800	13/07/2012	102	19504	0	0	0	0	0	0
1342213200	14/07/2012	79	19583	0	0	0	0	0	0
1342299600	15/07/2012	106	19689	0	0	0	0	0	0
1342386000	16/07/2012	115	19804	0	0	0	0	0	0
1342472400	17/07/2012	106	19910	0	0	0	0	0	0
1342558800	18/07/2012	285	20195	0	0	0	0	0	0
1342645200	19/07/2012	250	20445	0	0	0	0	0	0
1342731600	20/07/2012	253	20698	0	0	0	0	0	0
1342818000	21/07/2012	152	20850	0	0	0	0	0	0
1342904400	22/07/2012	147	20997	0	0	0	0	0	0
1342990800	23/07/2012	160	21157	0	0	0	0	0	0
1343077200	24/07/2012	209	21366	0	0	0	0	0	0
1343163600	25/07/2012	147	21513	0	0	0	0	0	0
1343250000	26/07/2012	204	21717	0	0	0	0	0	0
1343336400	27/07/2012	175	21892	0	0	0	0	0	0
1343422800	28/07/2012	206	22098	0	0	0	0	0	0
1343509200	29/07/2012	165	22263	0	0	0	0	0	0
1343595600	30/07/2012	129	22392	0	0	0	0	0	0
1343682000	31/07/2012	110	22502	0	0	0	0	0	0
1343768400	01/08/2012	192	22694	0	0	0	0	0	0
1343854800	02/08/2012	194	22888	0	0	0	0	0	0
1343941200	03/08/2012	141	23029	0	0	0	0	0	0
1344027600	04/08/2012	205	23234	0	0	0	0	0	0
1344114000	05/08/2012	127	23361	0	0	0	0	0	0
1344200400	06/08/2012	243	23604	0	0	0	0	0	0
1344286800	07/08/2012	221	23825	0	0	0	0	0	0
1344373200	08/08/2012	193	24018	0	0	0	0	0	0
1344459600	09/08/2012	180	24198	0	0	0	0	0	0
1344546000	10/08/2012	157	24355	0	0	0	0	0	0
1344632400	11/08/2012	141	24496	0	0	0	0	0	0
1344718800	12/08/2012	131	24627	0	0	0	0	0	0
1344805200	13/08/2012	143	24770	0	0	0	0	0	0
1344891600	14/08/2012	155	24925	0	0	0	0	0	0
1344978000	15/08/2012	207	25132	0	0	0	0	0	0
1345064400	16/08/2012	283	25415	0	0	0	0	0	0
1345150800	17/08/2012	190	25605	0	0	0	0	0	0
1345237200	18/08/2012	197	25802	0	0	0	0	0	0
1345323600	19/08/2012	177	25979	0	0	0	0	0	0
1345410000	20/08/2012	187	26166	0	0	0	0	0	0
1345496400	21/08/2012	236	26402	0	0	0	0	0	0
1345582800	22/08/2012	208	26610	0	0	0	0	0	0
1345669200	23/08/2012	222	26832	0	0	0	0	0	0
1345755600	24/08/2012	248	27080	0	0	0	0	0	0
1345842000	25/08/2012	431	27511	0	0	0	0	0	0
1345928400	26/08/2012	297	27808	0	0	0	0	0	0
1346014800	27/08/2012	282	28090	0	0	0	0	0	0
1346101200	28/08/2012	195	28285	0	0	0	0	0	0
1346187600	29/08/2012	166	28451	0	0	0	0	0	0
1346274000	30/08/2012	219	28670	0	0	0	0	0	0
1346360400	31/08/2012	130	28800	0	0	0	0	0	0
1346446800	01/09/2012	209	29009	0	0	0	0	0	0
1346533200	02/09/2012	145	29154	0	0	0	0	0	0
1346619600	03/09/2012	249	29403	0	0	0	0	0	0
1346706000	04/09/2012	166	29569	0	0	0	0	0	0
1346792400	05/09/2012	255	29824	0	0	0	0	0	0
1346878800	06/09/2012	176	30000	0	0	0	0	0	0
1346965200	07/09/2012	162	30162	0	0	0	0	0	0
1347051600	08/09/2012	185	30347	0	0	0	0	0	0
1347138000	09/09/2012	166	30513	0	0	0	0	0	0
1347224400	10/09/2012	149	30662	0	0	0	0	0	0
1347310800	11/09/2012	174	30836	0	0	0	0	0	0
1347397200	12/09/2012	178	31014	0	0	0	0	0	0
1347483600	13/09/2012	155	31169	0	0	0	0	0	0
1347570000	14/09/2012	161	31330	0	0	0	0	0	0
1347656400	15/09/2012	180	31510	0	0	0	0	0	0
1347742800	16/09/2012	167	31677	0	0	0	0	0	0
1347829200	17/09/2012	145	31822	0	0	0	0	0	0
1347915600	18/09/2012	182	32004	0	0	0	0	0	0
1348002000	19/09/2012	178	32182	0	0	0	0	0	0
1348088400	20/09/2012	237	32419	0	0	0	0	0	0
1348174800	21/09/2012	131	32550	0	0	0	0	0	0
1348261200	22/09/2012	186	32736	0	0	0	0	0	0
1348347600	23/09/2012	85	32821	0	0	0	0	0	0
1348434000	24/09/2012	143	32964	0	0	0	0	0	0
1348520400	25/09/2012	203	33167	0	0	0	0	0	0
1348606800	26/09/2012	396	33563	0	0	0	0	0	0
1348693200	27/09/2012	154	33717	0	0	0	0	0	0
1348779600	28/09/2012	206	33923	0	0	0	0	0	0
1348866000	29/09/2012	151	34074	0	0	0	0	0	0
1348952400	30/09/2012	164	34238	0	0	0	0	0	0
1349038800	01/10/2012	216	34454	0	0	0	0	0	0
1349125200	02/10/2012	155	34609	0	0	0	0	0	0
1349211600	03/10/2012	200	34809	0	0	0	0	0	0
1349298000	04/10/2012	124	34933	0	0	0	0	0	0
1349384400	05/10/2012	130	35063	0	0	0	0	0	0
1349470800	06/10/2012	103	35166	0	0	0	0	0	0
1349557200	07/10/2012	155	35321	0	0	0	0	0	0
1349643600	08/10/2012	197	35518	0	0	0	0	0	0
1349730000	09/10/2012	205	35723	0	0	0	0	0	0
1349816400	10/10/2012	200	35923	0	0	0	0	0	0
1349902800	11/10/2012	232	36155	0	0	0	0	0	0
1349989200	12/10/2012	128	36283	0	0	0	0	0	0
1350075600	13/10/2012	169	36452	0	0	0	0	0	0
1350162000	14/10/2012	220	36672	0	0	0	0	0	0
1350248400	15/10/2012	112	36784	0	0	0	0	0	0
1350334800	16/10/2012	149	36933	0	0	0	0	0	0
1350421200	17/10/2012	188	37121	0	0	0	0	0	0
1350507600	18/10/2012	222	37343	0	0	0	0	0	0
1350594000	19/10/2012	236	37579	0	0	0	0	0	0
1350680400	20/10/2012	119	37698	0	0	0	0	0	0
1350766800	21/10/2012	145	37843	0	0	0	0	0	0
1350853200	22/10/2012	127	37970	0	0	0	0	0	0
1350939600	23/10/2012	161	38131	0	0	0	0	0	0
1351026000	24/10/2012	151	38282	0	0	0	0	0	0
1351112400	25/10/2012	107	38389	0	0	0	0	0	0
1351198800	26/10/2012	127	38516	0	0	0	0	0	0
1351285200	27/10/2012	96	38612	0	0	0	0	0	0
1351371600	28/10/2012	153	38765	0	0	0	0	0	0
1351461600	29/10/2012	108	38873	0	0	0	0	0	0
1351548000	30/10/2012	156	39029	0	0	0	0	0	0
1351634400	31/10/2012	150	39179	0	0	0	0	0	0
1351720800	01/11/2012	172	39351	0	0	0	0	0	0
1351807200	02/11/2012	238	39589	0	0	0	0	0	0
1351893600	03/11/2012	177	39766	0	0	0	0	0	0
1351980000	04/11/2012	201	39967	0	0	0	0	0	0
1352066400	05/11/2012	163	40130	0	0	0	0	0	0
1352152800	06/11/2012	158	40288	0	0	0	0	0	0
1352239200	07/11/2012	177	40465	0	0	0	0	0	0
1352325600	08/11/2012	136	40601	0	0	0	0	0	0
1352412000	09/11/2012	156	40757	0	0	0	0	0	0
1352498400	10/11/2012	106	40863	0	0	0	0	0	0
1352584800	11/11/2012	88	40951	0	0	0	0	0	0
1352671200	12/11/2012	142	41093	0	0	0	0	0	0
1352757600	13/11/2012	178	41271	0	0	0	0	0	0
1352844000	14/11/2012	100	41371	0	0	0	0	0	0
1352930400	15/11/2012	130	41501	0	0	0	0	0	0
1353016800	16/11/2012	121	41622	0	0	0	0	0	0
1353103200	17/11/2012	136	41758	0	0	0	0	0	0
1353189600	18/11/2012	70	41828	0	0	0	0	0	0
1353276000	19/11/2012	172	42000	0	0	0	0	0	0
1353362400	20/11/2012	121	42121	0	0	0	0	0	0
1353448800	21/11/2012	129	42250	0	0	0	0	0	0
1353535200	22/11/2012	130	42380	0	0	0	0	0	0
1353621600	23/11/2012	75	42455	0	0	0	0	0	0
1353708000	24/11/2012	86	42541	0	0	0	0	0	0
1353794400	25/11/2012	134	42675	0	0	0	0	0	0
1353880800	26/11/2012	150	42825	0	0	0	0	0	0
1353967200	27/11/2012	116	42941	0	0	0	0	0	0
1354053600	28/11/2012	140	43081	0	0	0	0	0	0
1354140000	29/11/2012	92	43173	0	0	0	0	0	0
1354226400	30/11/2012	161	43334	0	0	0	0	0	0
1354312800	01/12/2012	177	43511	0	0	0	0	0	0
1354399200	02/12/2012	182	43693	0	0	0	0	0	0
1354485600	03/12/2012	213	43906	0	0	0	0	0	0
1354572000	04/12/2012	130	44036	0	0	0	0	0	0
1354658400	05/12/2012	115	44151	0	0	0	0	0	0
1354744800	06/12/2012	89	44240	0	0	0	0	0	0
1354831200	07/12/2012	87	44327	0	0	0	0	0	0
1354917600	08/12/2012	109	44436	0	0	0	0	0	0
1355004000	09/12/2012	117	44553	0	0	0	0	0	0
1355090400	10/12/2012	138	44691	0	0	0	0	0	0
1355176800	11/12/2012	195	44886	0	0	0	0	0	0
1355263200	12/12/2012	119	45005	0	0	0	0	0	0
1355349600	13/12/2012	200	45205	0	0	0	0	0	0
1355436000	14/12/2012	95	45300	0	0	0	0	0	0
1355522400	15/12/2012	139	45439	0	0	0	0	0	0
1355608800	16/12/2012	191	45630	0	0	0	0	0	0
1355695200	17/12/2012	157	45787	0	0	0	0	0	0
1355781600	18/12/2012	129	45916	0	0	0	0	0	0
1355868000	19/12/2012	175	46091	0	0	0	0	0	0
1355954400	20/12/2012	124	46215	0	0	0	0	0	0
1356040800	21/12/2012	146	46361	0	0	0	0	0	0
1356127200	22/12/2012	123	46484	0	0	0	0	0	0
1356213600	23/12/2012	225	46709	0	0	0	0	0	0
1356300000	24/12/2012	148	46857	0	0	0	0	0	0
1356386400	25/12/2012	188	47045	0	0	0	0	0	0
1356472800	26/12/2012	142	47187	0	0	0	0	0	0
1356559200	27/12/2012	128	47315	0	0	0	0	0	0
1356645600	28/12/2012	144	47459	0	0	0	0	0	0
1356732000	29/12/2012	175	47634	0	0	0	0	0	0
1356818400	30/12/2012	105	47739	0	0	0	0	0	0
1356904800	31/12/2012	151	47890	0	0	0	0	0	0
1356991200	01/01/2013	120	48010	0	0	0	0	0	0
1357077600	02/01/2013	188	48198	0	0	0	0	0	0
1357164000	03/01/2013	186	48384	0	0	0	0	0	0
1357250400	04/01/2013	131	48515	0	0	0	0	0	0
1357336800	05/01/2013	92	48607	0	0	0	0	0	0
1357423200	06/01/2013	92	48699	0	0	0	0	0	0
1357509600	07/01/2013	81	48780	0	0	0	0	0	0
1357596000	08/01/2013	114	48894	0	0	0	0	0	0
1357682400	09/01/2013	100	48994	0	0	0	0	0	0
1357768800	10/01/2013	47	49041	0	0	0	0	0	0
1357855200	11/01/2013	72	49113	0	0	0	0	0	0
1357941600	12/01/2013	126	49239	0	0	0	0	0	0
1358028000	13/01/2013	152	49391	0	0	0	0	0	0
1358114400	14/01/2013	148	49539	0	0	0	0	0	0
1358200800	15/01/2013	254	49793	0	0	0	0	0	0
1358287200	16/01/2013	177	49970	0	0	0	0	0	0
1358373600	17/01/2013	148	50118	0	0	0	0	0	0
1358460000	18/01/2013	197	50315	0	0	0	0	0	0
1358546400	19/01/2013	116	50431	0	0	0	0	0	0
1358632800	20/01/2013	155	50586	0	0	0	0	0	0
1358719200	21/01/2013	155	50741	0	0	0	0	0	0
1358805600	22/01/2013	150	50891	0	0	0	0	0	0
1358892000	23/01/2013	133	51024	0	0	0	0	0	0
1358978400	24/01/2013	98	51122	0	0	0	0	0	0
1359064800	25/01/2013	139	51261	0	0	0	0	0	0
1359151200	26/01/2013	131	51392	0	0	0	0	0	0
1359237600	27/01/2013	95	51487	0	0	0	0	0	0
1359324000	28/01/2013	141	51628	0	0	0	0	0	0
1359410400	29/01/2013	245	51873	0	0	0	0	0	0
1359496800	30/01/2013	139	52012	0	0	0	0	0	0
1359583200	31/01/2013	142	52154	0	0	0	0	0	0
1359669600	01/02/2013	83	52237	0	0	0	0	0	0
1359756000	02/02/2013	131	52368	0	0	0	0	0	0
1359842400	03/02/2013	158	52526	0	0	0	0	0	0
1359928800	04/02/2013	126	52652	0	0	0	0	0	0
1360015200	05/02/2013	124	52776	0	0	0	0	0	0
1360101600	06/02/2013	193	52969	0	0	0	0	0	0
1360188000	07/02/2013	143	53112	0	0	0	0	0	0
1360274400	08/02/2013	126	53238	0	0	0	0	0	0
1360360800	09/02/2013	155	53393	0	0	0	0	0	0
1360447200	10/02/2013	98	53491	0	0	0	0	0	0
1360533600	11/02/2013	113	53604	0	0	0	0	0	0
1360620000	12/02/2013	142	53746	0	0	0	0	0	0
1360706400	13/02/2013	225	53971	0	0	0	0	0	0
1360792800	14/02/2013	127	54098	0	0	0	0	0	0
1360879200	15/02/2013	102	54200	0	0	0	0	0	0
1360965600	16/02/2013	121	54321	0	0	0	0	0	0
1361052000	17/02/2013	114	54435	0	0	0	0	0	0
1361138400	18/02/2013	89	54524	0	0	0	0	0	0
1361224800	19/02/2013	182	54706	0	0	0	0	0	0
1361311200	20/02/2013	177	54883	0	0	0	0	0	0
1361397600	21/02/2013	262	55145	0	0	0	0	0	0
1361484000	22/02/2013	231	55376	0	0	0	0	0	0
1361570400	23/02/2013	87	55463	0	0	0	0	0	0
1361656800	24/02/2013	133	55596	0	0	0	0	0	0
1361743200	25/02/2013	137	55733	0	0	0	0	0	0
1361829600	26/02/2013	119	55852	0	0	0	0	0	0
1361916000	27/02/2013	213	56065	0	0	0	0	0	0
1362002400	28/02/2013	106	56171	0	0	0	0	0	0
1362088800	01/03/2013	134	56305	0	0	0	0	0	0
1362175200	02/03/2013	124	56429	0	0	0	0	0	0
1362261600	03/03/2013	157	56586	0	0	0	0	0	0
1362348000	04/03/2013	119	56705	0	0	0	0	0	0
1362434400	05/03/2013	145	56850	0	0	0	0	0	0
1362520800	06/03/2013	173	57023	0	0	0	0	0	0
1362607200	07/03/2013	112	57135	0	0	0	0	0	0
1362693600	08/03/2013	87	57222	0	0	0	0	0	0
1362780000	09/03/2013	122	57344	0	0	0	0	0	0
1362866400	10/03/2013	144	57488	0	0	0	0	0	0
1362952800	11/03/2013	123	57611	0	0	0	0	0	0
1363039200	12/03/2013	87	57698	0	0	0	0	0	0
1363125600	13/03/2013	118	57816	0	0	0	0	0	0
1363212000	14/03/2013	169	57985	0	0	0	0	0	0
1363298400	15/03/2013	167	58152	0	0	0	0	0	0
1363384800	16/03/2013	151	58303	0	0	0	0	0	0
1363471200	17/03/2013	97	58400	0	0	0	0	0	0
1363557600	18/03/2013	186	58586	0	0	0	0	0	0
1363644000	19/03/2013	147	58733	0	0	0	0	0	0
1363730400	20/03/2013	165	58898	0	0	0	0	0	0
1363816800	21/03/2013	185	59083	0	0	0	0	0	0
1363903200	22/03/2013	100	59183	0	0	0	0	0	0
1363989600	23/03/2013	88	59271	0	0	0	0	0	0
1364076000	24/03/2013	175	59446	0	0	0	0	0	0
1364162400	25/03/2013	143	59589	0	0	0	0	0	0
1364248800	26/03/2013	143	59732	0	0	0	0	0	0
1364335200	27/03/2013	123	59855	0	0	0	0	0	0
1364421600	28/03/2013	154	60009	0	0	0	0	0	0
1364508000	29/03/2013	158	60167	0	0	0	0	0	0
1364594400	30/03/2013	109	60276	0	0	0	0	0	0
1364680800	31/03/2013	182	60458	0	0	0	0	0	0
1364763600	01/04/2013	164	60622	0	0	0	0	0	0
1364850000	02/04/2013	113	60735	0	0	0	0	0	0
1364936400	03/04/2013	151	60886	0	0	0	0	0	0
1365022800	04/04/2013	127	61013	0	0	0	0	0	0
1365109200	05/04/2013	92	61105	0	0	0	0	0	0
1365195600	06/04/2013	138	61243	0	0	0	0	0	0
1365282000	07/04/2013	151	61394	0	0	0	0	0	0
1365368400	08/04/2013	96	61490	0	0	0	0	0	0
1365454800	09/04/2013	150	61640	0	0	0	0	0	0
1365541200	10/04/2013	184	61824	0	0	0	0	0	0
1365627600	11/04/2013	156	61980	0	0	0	0	0	0
1365714000	12/04/2013	105	62085	0	0	0	0	0	0
1365800400	13/04/2013	124	62209	0	0	0	0	0	0
1365886800	14/04/2013	173	62382	0	0	0	0	0	0
1365973200	15/04/2013	80	62462	0	0	0	0	0	0
1366059600	16/04/2013	138	62600	0	0	0	0	0	0
1366146000	17/04/2013	191	62791	0	0	0	0	0	0
1366232400	18/04/2013	100	62891	0	0	0	0	0	0
1366318800	19/04/2013	146	63037	0	0	0	0	0	0
1366405200	20/04/2013	91	63128	0	0	0	0	0	0
1366491600	21/04/2013	602	63730	0	0	0	0	0	0
1366578000	22/04/2013	138	63868	0	0	0	0	0	0
1366664400	23/04/2013	150	64018	0	0	0	0	0	0
1366750800	24/04/2013	135	64153	0	0	0	0	0	0
1366837200	25/04/2013	117	64270	0	0	0	0	0	0
1366923600	26/04/2013	132	64402	0	0	0	0	0	0
1367010000	27/04/2013	155	64557	0	0	0	0	0	0
1367096400	28/04/2013	125	64682	0	0	0	0	0	0
1367182800	29/04/2013	126	64808	0	0	0	0	0	0
1367269200	30/04/2013	171	64979	0	0	0	0	0	0
1367355600	01/05/2013	99	65078	0	0	0	0	0	0
1367442000	02/05/2013	365	65443	0	0	0	0	0	0
1367528400	03/05/2013	117	65560	0	0	0	0	0	0
1367614800	04/05/2013	247	65807	0	0	0	0	0	0
1367701200	05/05/2013	91	65898	0	0	0	0	0	0
1367787600	06/05/2013	101	65999	0	0	0	0	0	0
1367874000	07/05/2013	135	66134	0	0	0	0	0	0
1367960400	08/05/2013	86	66220	0	0	0	0	0	0
1368046800	09/05/2013	66	66286	0	0	0	0	0	0
1368133200	10/05/2013	118	66404	0	0	0	0	0	0
1368219600	11/05/2013	81	66485	0	0	0	0	0	0
1368306000	12/05/2013	82	66567	0	0	0	0	0	0
1368392400	13/05/2013	83	66650	0	0	0	0	0	0
1368478800	14/05/2013	96	66746	0	0	0	0	0	0
1368565200	15/05/2013	117	66863	0	0	0	0	0	0
1368651600	16/05/2013	126	66989	0	0	0	0	0	0
1368738000	17/05/2013	131	67120	0	0	0	0	0	0
1368824400	18/05/2013	107	67227	0	0	0	0	0	0
1368910800	19/05/2013	137	67364	0	0	0	0	0	0
1368997200	20/05/2013	116	67480	0	0	0	0	0	0
1369083600	21/05/2013	86	67566	0	0	0	0	0	0
1369170000	22/05/2013	158	67724	0	0	0	0	0	0
1369256400	23/05/2013	94	67818	0	0	0	0	0	0
1369342800	24/05/2013	106	67924	0	0	0	0	0	0
1369429200	25/05/2013	119	68043	0	0	0	0	0	0
1369515600	26/05/2013	109	68152	0	0	0	0	0	0
1369602000	27/05/2013	110	68262	0	0	0	0	0	0
1369688400	28/05/2013	123	68385	0	0	0	0	0	0
1369774800	29/05/2013	146	68531	0	0	0	0	0	0
1369861200	30/05/2013	114	68645	0	0	0	0	0	0
1369947600	31/05/2013	193	68838	0	0	0	0	0	0
1370034000	01/06/2013	136	68974	0	0	0	0	0	0
1370120400	02/06/2013	94	69068	0	0	0	0	0	0
1370206800	03/06/2013	103	69171	0	0	0	0	0	0
1370293200	04/06/2013	85	69256	0	0	0	0	0	0
1370379600	05/06/2013	77	69333	0	0	0	0	0	0
1370466000	06/06/2013	112	69445	0	0	0	0	0	0
1370552400	07/06/2013	101	69546	0	0	0	0	0	0
1370638800	08/06/2013	91	69637	0	0	0	0	0	0
1370725200	09/06/2013	174	69811	0	0	0	0	0	0
1370811600	10/06/2013	87	69898	0	0	0	0	0	0
1370898000	11/06/2013	128	70026	0	0	0	0	0	0
1370984400	12/06/2013	88	70114	0	0	0	0	0	0
1371070800	13/06/2013	104	70218	0	0	0	0	0	0
1371157200	14/06/2013	66	70284	0	0	0	0	0	0
1371243600	15/06/2013	81	70365	0	0	0	0	0	0
1371330000	16/06/2013	90	70455	0	0	0	0	0	0
1371416400	17/06/2013	94	70549	0	0	0	0	0	0
1371502800	18/06/2013	94	70643	0	0	0	0	0	0
1371589200	19/06/2013	97	70740	0	0	0	0	0	0
1371675600	20/06/2013	118	70858	0	0	0	0	0	0
1371762000	21/06/2013	103	70961	0	0	0	0	0	0
1371848400	22/06/2013	192	71153	0	0	0	0	0	0
1371934800	23/06/2013	134	71287	0	0	0	0	0	0
1372021200	24/06/2013	75	71362	0	0	0	0	0	0
1372107600	25/06/2013	96	71458	0	0	0	0	0	0
1372194000	26/06/2013	82	71540	0	0	0	0	0	0
1372280400	27/06/2013	126	71666	0	0	0	0	0	0
1372366800	28/06/2013	51	71717	0	0	0	0	0	0
1372453200	29/06/2013	86	71803	0	0	0	0	0	0
1372539600	30/06/2013	73	71876	0	0	0	0	0	0
1372626000	01/07/2013	61	71937	0	0	0	0	0	0
1372712400	02/07/2013	105	72042	0	0	0	0	0	0
1372798800	03/07/2013	105	72147	0	0	0	0	0	0
1372885200	04/07/2013	79	72226	0	0	0	0	0	0
1372971600	05/07/2013	90	72316	0	0	0	0	0	0
1373058000	06/07/2013	41	72357	0	0	0	0	0	0
1373144400	07/07/2013	66	72423	0	0	0	0	0	0
1373230800	08/07/2013	67	72490	0	0	0	0	0	0
1373317200	09/07/2013	67	72557	0	0	0	0	0	0
1373403600	10/07/2013	111	72668	0	0	0	0	0	0
1373490000	11/07/2013	61	72729	0	0	0	0	0	0
1373576400	12/07/2013	77	72806	0	0	0	0	0	0
1373662800	13/07/2013	89	72895	0	0	0	0	0	0
1373749200	14/07/2013	120	73015	0	0	0	0	0	0
1373835600	15/07/2013	97	73112	0	0	0	0	0	0
1373922000	16/07/2013	99	73211	0	0	0	0	0	0
1374008400	17/07/2013	103	73314	0	0	0	0	0	0
1374094800	18/07/2013	144	73458	0	0	0	0	0	0
1374181200	19/07/2013	73	73531	0	0	0	0	0	0
1374267600	20/07/2013	76	73607	0	0	0	0	0	0
1374354000	21/07/2013	228	73835	0	0	0	0	0	0
1374440400	22/07/2013	110	73945	0	0	0	0	0	0
1374526800	23/07/2013	154	74099	0	0	0	0	0	0
1374613200	24/07/2013	133	74232	0	0	0	0	0	0
1374699600	25/07/2013	94	74326	0	0	0	0	0	0
1374786000	26/07/2013	143	74469	0	0	0	0	0	0
1374872400	27/07/2013	99	74568	0	0	0	0	0	0
1374958800	28/07/2013	118	74686	0	0	0	0	0	0
1375045200	29/07/2013	125	74811	0	0	0	0	0	0
1375131600	30/07/2013	152	74963	0	0	0	0	0	0
1375218000	31/07/2013	101	75064	0	0	0	0	0	0
1375304400	01/08/2013	134	75198	0	0	0	0	0	0
1375390800	02/08/2013	103	75301	0	0	0	0	0	0
1375477200	03/08/2013	125	75426	0	0	0	0	0	0
1375563600	04/08/2013	130	75556	0	0	0	0	0	0
1375650000	05/08/2013	123	75679	0	0	0	0	0	0
1375736400	06/08/2013	168	75847	0	0	0	0	0	0
1375822800	07/08/2013	155	76002	0	0	0	0	0	0
1375909200	08/08/2013	108	76110	0	0	0	0	0	0
1375995600	09/08/2013	90	76200	0	0	0	0	0	0
1376082000	10/08/2013	154	76354	0	0	0	0	0	0
1376168400	11/08/2013	128	76482	0	0	0	0	0	0
1376254800	12/08/2013	63	76545	0	0	0	0	0	0
1376341200	13/08/2013	99	76644	0	0	0	0	0	0
1376427600	14/08/2013	99	76743	0	0	0	0	0	0
1376514000	15/08/2013	76	76819	0	0	0	0	0	0
1376600400	16/08/2013	118	76937	0	0	0	0	0	0
1376686800	17/08/2013	102	77039	0	0	0	0	0	0
1376773200	18/08/2013	81	77120	0	0	0	0	0	0
1376859600	19/08/2013	77	77197	0	0	0	0	0	0
1376946000	20/08/2013	84	77281	0	0	0	0	0	0
1377032400	21/08/2013	1482	78763	0	0	0	0	0	0
1377118800	22/08/2013	177	78940	0	0	0	0	0	0
1377205200	23/08/2013	93	79033	0	0	0	0	0	0
1377291600	24/08/2013	128	79161	0	0	0	0	0	0
1377378000	25/08/2013	111	79272	0	0	0	0	0	0
1377464400	26/08/2013	160	79432	0	0	0	0	0	0
1377550800	27/08/2013	89	79521	0	0	0	0	0	0
1377637200	28/08/2013	56	79577	0	0	0	0	0	0
1377723600	29/08/2013	75	79652	0	0	0	0	0	0
1377810000	30/08/2013	76	79728	0	0	0	0	0	0
1377896400	31/08/2013	62	79790	0	0	0	0	0	0
1377982800	01/09/2013	157	79947	0	0	0	0	0	0
1378069200	02/09/2013	99	80046	0	0	0	0	0	0
1378155600	03/09/2013	88	80134	0	0	0	0	0	0
1378242000	04/09/2013	83	80217	0	0	0	0	0	0
1378328400	05/09/2013	93	80310	0	0	0	0	0	0
1378414800	06/09/2013	88	80398	0	0	0	0	0	0
1378501200	07/09/2013	126	80524	0	0	0	0	0	0
1378587600	08/09/2013	90	80614	0	0	0	0	0	0
1378674000	09/09/2013	75	80689	0	0	0	0	0	0
1378760400	10/09/2013	83	80772	0	0	0	0	0	0
1378846800	11/09/2013	82	80854	0	0	0	0	0	0
1378933200	12/09/2013	118	80972	0	0	0	0	0	0
1379019600	13/09/2013	86	81058	0	0	0	0	0	0
1379106000	14/09/2013	122	81180	0	0	0	0	0	0
1379192400	15/09/2013	100	81280	0	0	0	0	0	0
1379278800	16/09/2013	106	81386	0	0	0	0	0	0
1379365200	17/09/2013	89	81475	0	0	0	0	0	0
1379451600	18/09/2013	107	81582	0	0	0	0	0	0
1379538000	19/09/2013	137	81719	0	0	0	0	0	0
1379624400	20/09/2013	88	81807	0	0	0	0	0	0
1379710800	21/09/2013	103	81910	0	0	0	0	0	0
1379797200	22/09/2013	89	81999	0	0	0	0	0	0
1379883600	23/09/2013	71	82070	0	0	0	0	0	0
1379970000	24/09/2013	67	82137	0	0	0	0	0	0
1380056400	25/09/2013	114	82251	0	0	0	0	0	0
1380142800	26/09/2013	88	82339	0	0	0	0	0	0
1380229200	27/09/2013	119	82458	0	0	0	0	0	0
1380315600	28/09/2013	78	82536	0	0	0	0	0	0
1380402000	29/09/2013	94	82630	0	0	0	0	0	0
1380488400	30/09/2013	81	82711	0	0	0	0	0	0
1380574800	01/10/2013	89	82800	0	0	0	0	0	0
1380661200	02/10/2013	81	82881	0	0	0	0	0	0
1380747600	03/10/2013	63	82944	0	0	0	0	0	0
1380834000	04/10/2013	95	83039	0	0	0	0	0	0
1380920400	05/10/2013	71	83110	0	0	0	0	0	0
1381006800	06/10/2013	100	83210	0	0	0	0	0	0
1381093200	07/10/2013	81	83291	0	0	0	0	0	0
1381179600	08/10/2013	98	83389	0	0	0	0	0	0
1381266000	09/10/2013	109	83498	0	0	0	0	0	0
1381352400	10/10/2013	112	83610	0	0	0	0	0	0
1381438800	11/10/2013	118	83728	0	0	0	0	0	0
1381525200	12/10/2013	123	83851	0	0	0	0	0	0
1381611600	13/10/2013	104	83955	0	0	0	0	0	0
1381698000	14/10/2013	119	84074	0	0	0	0	0	0
1381784400	15/10/2013	93	84167	0	0	0	0	0	0
1381870800	16/10/2013	76	84243	0	0	0	0	0	0
1381957200	17/10/2013	90	84333	0	0	0	0	0	0
1382043600	18/10/2013	61	84394	0	0	0	0	0	0
1382130000	19/10/2013	69	84463	0	0	0	0	0	0
1382216400	20/10/2013	79	84542	0	0	0	0	0	0
1382302800	21/10/2013	69	84611	0	0	0	0	0	0
1382389200	22/10/2013	97	84708	0	0	0	0	0	0
1382475600	23/10/2013	110	84818	0	0	0	0	0	0
1382562000	24/10/2013	65	84883	0	0	0	0	0	0
1382648400	25/10/2013	329	85212	0	0	0	0	0	0
1382734800	26/10/2013	105	85317	0	0	0	0	0	0
1382821200	27/10/2013	82	85399	0	0	0	0	0	0
1382911200	28/10/2013	61	85460	0	0	0	0	0	0
1382997600	29/10/2013	72	85532	0	0	0	0	0	0
1383084000	30/10/2013	74	85606	0	0	0	0	0	0
1383170400	31/10/2013	78	85684	0	0	0	0	0	0
1383256800	01/11/2013	94	85778	0	0	0	0	0	0
1383343200	02/11/2013	71	85849	0	0	0	0	0	0
1383429600	03/11/2013	48	85897	0	0	0	0	0	0
1383516000	04/11/2013	84	85981	0	0	0	0	0	0
1383602400	05/11/2013	64	86045	0	0	0	0	0	0
1383688800	06/11/2013	66	86111	0	0	0	0	0	0
1383775200	07/11/2013	65	86176	0	0	0	0	0	0
1383861600	08/11/2013	111	86287	0	0	0	0	0	0
1383948000	09/11/2013	88	86375	0	0	0	0	0	0
1384034400	10/11/2013	67	86442	0	0	0	0	0	0
1384120800	11/11/2013	112	86554	0	0	0	0	0	0
1384207200	12/11/2013	80	86634	0	0	0	0	0	0
1384293600	13/11/2013	82	86716	0	0	0	0	0	0
1384380000	14/11/2013	104	86820	0	0	0	0	0	0
1384466400	15/11/2013	98	86918	0	0	0	0	0	0
1384552800	16/11/2013	103	87021	0	0	0	0	0	0
1384639200	17/11/2013	63	87084	0	0	0	0	0	0
1384725600	18/11/2013	91	87175	0	0	0	0	0	0
1384812000	19/11/2013	64	87239	0	0	0	0	0	0
1384898400	20/11/2013	59	87298	0	0	0	0	0	0
1384984800	21/11/2013	93	87391	0	0	0	0	0	0
1385071200	22/11/2013	101	87492	0	0	0	0	0	0
1385157600	23/11/2013	161	87653	0	0	0	0	0	0
1385244000	24/11/2013	100	87753	0	0	0	0	0	0
1385330400	25/11/2013	105	87858	0	0	0	0	0	0
1385416800	26/11/2013	101	87959	0	0	0	0	0	0
1385503200	27/11/2013	87	88046	0	0	0	0	0	0
1385589600	28/11/2013	156	88202	0	0	0	0	0	0
1385676000	29/11/2013	108	88310	0	0	0	0	0	0
1385762400	30/11/2013	138	88448	0	0	0	0	0	0
1385848800	01/12/2013	124	88572	0	0	0	0	0	0
1385935200	02/12/2013	95	88667	0	0	0	0	0	0
1386021600	03/12/2013	39	88706	0	0	0	0	0	0
1386108000	04/12/2013	70	88776	0	0	0	0	0	0
1386194400	05/12/2013	66	88842	0	0	0	0	0	0
1386280800	06/12/2013	177	89019	0	0	0	0	0	0
1386367200	07/12/2013	140	89159	0	0	0	0	0	0
1386453600	08/12/2013	101	89260	0	0	0	0	0	0
1386540000	09/12/2013	127	89387	0	0	0	0	0	0
1386626400	10/12/2013	127	89514	0	0	0	0	0	0
1386712800	11/12/2013	93	89607	0	0	0	0	0	0
1386799200	12/12/2013	99	89706	0	0	0	0	0	0
1386885600	13/12/2013	75	89781	0	0	0	0	0	0
1386972000	14/12/2013	100	89881	0	0	0	0	0	0
1387058400	15/12/2013	175	90056	0	0	0	0	0	0
1387144800	16/12/2013	126	90182	0	0	0	0	0	0
1387231200	17/12/2013	208	90390	0	0	0	0	0	0
1387317600	18/12/2013	145	90535	0	0	0	0	0	0
1387404000	19/12/2013	154	90689	0	0	0	0	0	0
1387490400	20/12/2013	103	90792	0	0	0	0	0	0
1387576800	21/12/2013	153	90945	0	0	0	0	0	0
1387663200	22/12/2013	210	91155	0	0	0	0	0	0
1387749600	23/12/2013	176	91331	0	0	0	0	0	0
1387836000	24/12/2013	124	91455	0	0	0	0	0	0
1387922400	25/12/2013	77	91532	0	0	0	0	0	0
1388008800	26/12/2013	103	91635	0	0	0	0	0	0
1388095200	27/12/2013	75	91710	0	0	0	0	0	0
1388181600	28/12/2013	175	91885	0	0	0	0	0	0
1388268000	29/12/2013	83	91968	0	0	0	0	0	0
1388354400	30/12/2013	48	92016	0	0	0	0	0	0
1388440800	31/12/2013	115	92131	0	0	0	0	0	0
1388527200	01/01/2014	129	92260	0	0	0	0	0	0
1388613600	02/01/2014	60	92320	0	0	0	0	0	0
1388700000	03/01/2014	97	92417	0	0	0	0	0	0
1388786400	04/01/2014	72	92489	0	0	0	0	0	0
1388872800	05/01/2014	103	92592	0	0	0	0	0	0
1388959200	06/01/2014	153	92745	0	0	0	0	0	0
1389045600	07/01/2014	158	92903	0	0	0	0	0	0
1389132000	08/01/2014	164	93067	0	0	0	0	0	0
1389218400	09/01/2014	186	93253	0	0	0	0	0	0
1389304800	10/01/2014	91	93344	0	0	0	0	0	0
1389391200	11/01/2014	134	93478	0	0	0	0	0	0
1389477600	12/01/2014	189	93667	0	0	0	0	0	0
1389564000	13/01/2014	76	93743	0	0	0	0	0	0
1389650400	14/01/2014	74	93817	0	0	0	0	0	0
1389736800	15/01/2014	85	93902	0	0	0	0	0	0
1389823200	16/01/2014	86	93988	0	0	0	0	0	0
1389909600	17/01/2014	142	94130	0	0	0	0	0	0
1389996000	18/01/2014	186	94316	0	0	0	0	0	0
1390082400	19/01/2014	160	94476	0	0	0	0	0	0
1390168800	20/01/2014	97	94573	0	0	0	0	0	0
1390255200	21/01/2014	103	94676	0	0	0	0	0	0
1390341600	22/01/2014	90	94766	0	0	0	0	0	0
1390428000	23/01/2014	118	94884	0	0	0	0	0	0
1390514400	24/01/2014	89	94973	0	0	0	0	0	0
1390600800	25/01/2014	106	95079	0	0	0	0	0	0
1390687200	26/01/2014	90	95169	0	0	0	0	0	0
1390773600	27/01/2014	107	95276	0	0	0	0	0	0
1390860000	28/01/2014	157	95433	0	0	0	0	0	0
1390946400	29/01/2014	93	95526	0	0	0	0	0	0
1391032800	30/01/2014	117	95643	0	0	0	0	0	0
1391119200	31/01/2014	115	95758	0	0	0	0	0	0
1391205600	01/02/2014	175	95933	0	0	0	0	0	0
1391292000	02/02/2014	177	96110	0	0	0	0	0	0
1391378400	03/02/2014	135	96245	0	0	0	0	0	0
1391464800	04/02/2014	100	96345	0	0	0	0	0	0
1391551200	05/02/2014	67	96412	0	0	0	0	0	0
1391637600	06/02/2014	113	96525	0	0	0	0	0	0
1391724000	07/02/2014	132	96657	0	0	0	0	0	0
1391810400	08/02/2014	191	96848	0	0	0	0	0	0
1391896800	09/02/2014	210	97058	0	0	0	0	0	0
1391983200	10/02/2014	126	97184	0	0	0	0	0	0
1392069600	11/02/2014	97	97281	0	0	0	0	0	0
1392156000	12/02/2014	177	97458	0	0	0	0	0	0
1392242400	13/02/2014	63	97521	0	0	0	0	0	0
1392328800	14/02/2014	159	97680	0	0	0	0	0	0
1392415200	15/02/2014	139	97819	0	0	0	0	0	0
1392501600	16/02/2014	100	97919	0	0	0	0	0	0
1392588000	17/02/2014	84	98003	0	0	0	0	0	0
1392674400	18/02/2014	96	98099	0	0	0	0	0	0
1392760800	19/02/2014	103	98202	0	0	0	0	0	0
1392847200	20/02/2014	142	98344	0	0	0	0	0	0
1392933600	21/02/2014	115	98459	0	0	0	0	0	0
1393020000	22/02/2014	88	98547	0	0	0	0	0	0
1393106400	23/02/2014	164	98711	0	0	0	0	0	0
1393192800	24/02/2014	96	98807	0	0	0	0	0	0
1393279200	25/02/2014	43	98850	0	0	0	0	0	0
1393365600	26/02/2014	174	99024	0	0	0	0	0	0
1393452000	27/02/2014	73	99097	0	0	0	0	0	0
1393538400	28/02/2014	91	99188	0	0	0	0	0	0
1393624800	01/03/2014	133	99321	0	0	0	0	0	0
1393711200	02/03/2014	61	99382	0	0	0	0	0	0
1393797600	03/03/2014	86	99468	0	0	0	0	0	0
1393884000	04/03/2014	50	99518	0	0	0	0	0	0
1393970400	05/03/2014	79	99597	0	0	0	0	0	0
1394056800	06/03/2014	79	99676	0	0	0	0	0	0
1394143200	07/03/2014	146	99822	0	0	0	0	0	0
1394229600	08/03/2014	125	99947	0	0	0	0	0	0
1394316000	09/03/2014	92	100039	0	0	0	0	0	0
1394402400	10/03/2014	32	100071	0	0	0	0	0	0
1394488800	11/03/2014	104	100175	0	0	0	0	0	0
1394575200	12/03/2014	67	100242	0	0	0	0	0	0
1394661600	13/03/2014	45	100287	0	0	0	0	0	0
1394748000	14/03/2014	74	100361	0	0	0	0	0	0
1394834400	15/03/2014	128	100489	0	0	0	0	0	0
1394920800	16/03/2014	94	100583	0	0	0	0	0	0
1395007200	17/03/2014	69	100652	0	0	0	0	0	0
1395093600	18/03/2014	101	100753	0	0	0	0	0	0
1395180000	19/03/2014	83	100836	0	0	0	0	0	0
1395266400	20/03/2014	138	100974	0	0	0	0	0	0
1395352800	21/03/2014	101	101075	0	0	0	0	0	0
1395439200	22/03/2014	81	101156	0	0	0	0	0	0
1395525600	23/03/2014	99	101255	0	0	0	0	0	0
1395612000	24/03/2014	99	101354	0	0	0	0	0	0
1395698400	25/03/2014	75	101429	0	0	0	0	0	0
1395784800	26/03/2014	85	101514	0	0	0	0	0	0
1395871200	27/03/2014	86	101600	0	0	0	0	0	0
1395957600	28/03/2014	82	101682	0	0	0	0	0	0
1396044000	29/03/2014	57	101739	0	0	0	0	0	0
1396130400	30/03/2014	43	101782	0	0	0	0	0	0
1396213200	31/03/2014	81	101863	0	0	0	0	0	0
1396299600	01/04/2014	110	101973	0	0	0	0	0	0
1396386000	02/04/2014	124	102097	0	0	0	0	0	0
1396472400	03/04/2014	87	102184	0	0	0	0	0	0
1396558800	04/04/2014	132	102316	0	0	0	0	0	0
1396645200	05/04/2014	136	102452	0	0	0	0	0	0
1396731600	06/04/2014	135	102587	0	0	0	0	0	0
1396818000	07/04/2014	93	102680	0	0	0	0	0	0
1396904400	08/04/2014	91	102771	0	0	0	0	0	0
1396990800	09/04/2014	55	102826	0	0	0	0	0	0
1397077200	10/04/2014	149	102975	0	0	0	0	0	0
1397163600	11/04/2014	109	103084	0	0	0	0	0	0
1397250000	12/04/2014	94	103178	0	0	0	0	0	0
1397336400	13/04/2014	127	103305	0	0	0	0	0	0
1397422800	14/04/2014	102	103407	0	0	0	0	0	0
1397509200	15/04/2014	123	103530	0	0	0	0	0	0
1397595600	16/04/2014	77	103607	0	0	0	0	0	0
1397682000	17/04/2014	103	103710	0	0	0	0	0	0
1397768400	18/04/2014	104	103814	0	0	0	0	0	0
1397854800	19/04/2014	89	103903	0	0	0	0	0	0
1397941200	20/04/2014	189	104092	0	0	0	0	0	0
1398027600	21/04/2014	85	104177	0	0	0	0	0	0
1398114000	22/04/2014	58	104235	0	0	0	0	0	0
1398200400	23/04/2014	67	104302	0	0	0	0	0	0
1398286800	24/04/2014	143	104445	0	0	0	0	0	0
1398373200	25/04/2014	82	104527	0	0	0	0	0	0
1398459600	26/04/2014	100	104627	0	0	0	0	0	0
1398546000	27/04/2014	132	104759	0	0	0	0	0	0
1398632400	28/04/2014	108	104867	0	0	0	0	0	0
1398718800	29/04/2014	117	104984	0	0	0	0	0	0
1398805200	30/04/2014	100	105084	0	0	0	0	0	0
1398891600	01/05/2014	133	105217	0	0	0	0	0	0
1398978000	02/05/2014	93	105310	0	0	0	0	0	0
1399064400	03/05/2014	79	105389	0	0	0	0	0	0
1399150800	04/05/2014	72	105461	0	0	0	0	0	0
1399237200	05/05/2014	113	105574	0	0	0	0	0	0
1399323600	06/05/2014	78	105652	0	0	0	0	0	0
1399410000	07/05/2014	94	105746	0	0	0	0	0	0
1399496400	08/05/2014	77	105823	0	0	0	0	0	0
1399582800	09/05/2014	88	105911	0	0	0	0	0	0
1399669200	10/05/2014	96	106007	0	0	0	0	0	0
1399755600	11/05/2014	108	106115	0	0	0	0	0	0
1399842000	12/05/2014	66	106181	0	0	0	0	0	0
1399928400	13/05/2014	62	106243	0	0	0	0	0	0
1400014800	14/05/2014	142	106385	0	0	0	0	0	0
1400101200	15/05/2014	148	106533	0	0	0	0	0	0
1400187600	16/05/2014	110	106643	0	0	0	0	0	0
1400274000	17/05/2014	76	106719	0	0	0	0	0	0
1400360400	18/05/2014	45	106764	0	0	0	0	0	0
1400446800	19/05/2014	58	106822	0	0	0	0	0	0
1400533200	20/05/2014	99	106921	0	0	0	0	0	0
1400619600	21/05/2014	69	106990	0	0	0	0	0	0
1400706000	22/05/2014	88	107078	0	0	0	0	0	0
1400792400	23/05/2014	57	107135	0	0	0	0	0	0
1400878800	24/05/2014	56	107191	0	0	0	0	0	0
1400965200	25/05/2014	51	107242	0	0	0	0	0	0
1401051600	26/05/2014	107	107349	0	0	0	0	0	0
1401138000	27/05/2014	91	107440	0	0	0	0	0	0
1401224400	28/05/2014	104	107544	0	0	0	0	0	0
1401310800	29/05/2014	75	107619	0	0	0	0	0	0
1401397200	30/05/2014	108	107727	0	0	0	0	0	0
1401483600	31/05/2014	51	107778	0	0	0	0	0	0
1401570000	01/06/2014	62	107840	0	0	0	0	0	0
1401656400	02/06/2014	70	107910	0	0	0	0	0	0
1401742800	03/06/2014	161	108071	0	0	0	0	0	0
1401829200	04/06/2014	64	108135	0	0	0	0	0	0
1401915600	05/06/2014	56	108191	0	0	0	0	0	0
1402002000	06/06/2014	67	108258	0	0	0	0	0	0
1402088400	07/06/2014	105	108363	0	0	0	0	0	0
1402174800	08/06/2014	87	108450	0	0	0	0	0	0
1402261200	09/06/2014	72	108522	0	0	0	0	0	0
1402347600	10/06/2014	78	108600	0	0	0	0	0	0
1402434000	11/06/2014	76	108676	0	0	0	0	0	0
1402520400	12/06/2014	43	108719	0	0	0	0	0	0
1402606800	13/06/2014	85	108804	0	0	0	0	0	0
1402693200	14/06/2014	120	108924	0	0	0	0	0	0
1402779600	15/06/2014	107	109031	0	0	0	0	0	0
1402866000	16/06/2014	185	109216	0	0	0	0	0	0
1402952400	17/06/2014	66	109282	0	0	0	0	0	0
1403038800	18/06/2014	77	109359	0	0	0	0	0	0
1403125200	19/06/2014	57	109416	0	0	0	0	0	0
1403211600	20/06/2014	46	109462	0	0	0	0	0	0
1403298000	21/06/2014	85	109547	0	0	0	0	0	0
1403384400	22/06/2014	64	109611	0	0	0	0	0	0
1403470800	23/06/2014	56	109667	0	0	0	0	0	0
1403557200	24/06/2014	60	109727	0	0	0	0	0	0
1403643600	25/06/2014	115	109842	0	0	0	0	0	0
1403730000	26/06/2014	67	109909	0	0	0	0	0	0
1403816400	27/06/2014	56	109965	0	0	0	0	0	0
1403902800	28/06/2014	91	110056	0	0	0	0	0	0
1403989200	29/06/2014	119	110175	0	0	0	0	0	0
1404075600	30/06/2014	53	110228	0	0	0	0	0	0
1404162000	01/07/2014	98	110326	0	0	0	0	0	0
1404248400	02/07/2014	47	110373	0	0	0	0	0	0
1404334800	03/07/2014	50	110423	0	0	0	0	0	0
1404421200	04/07/2014	57	110480	0	0	0	0	0	0
1404507600	05/07/2014	55	110535	0	0	0	0	0	0
1404594000	06/07/2014	44	110579	0	0	0	0	0	0
1404680400	07/07/2014	46	110625	0	0	0	0	0	0
1404766800	08/07/2014	38	110663	0	0	0	0	0	0
1404853200	09/07/2014	97	110760	0	0	0	0	0	0
1404939600	10/07/2014	53	110813	0	0	0	0	0	0
1405026000	11/07/2014	67	110880	0	0	0	0	0	0
1405112400	12/07/2014	43	110923	0	0	0	0	0	0
1405198800	13/07/2014	55	110978	0	0	0	0	0	0
1405285200	14/07/2014	44	111022	0	0	0	0	0	0
1405371600	15/07/2014	69	111091	0	0	0	0	0	0
1405458000	16/07/2014	109	111200	0	0	0	0	0	0
1405544400	17/07/2014	49	111249	0	0	0	0	0	0
1405630800	18/07/2014	66	111315	0	0	0	0	0	0
1405717200	19/07/2014	91	111406	0	0	0	0	0	0
1405803600	20/07/2014	102	111508	0	0	0	0	0	0
1405890000	21/07/2014	78	111586	0	0	0	0	0	0
1405976400	22/07/2014	84	111670	0	0	0	0	0	0
1406062800	23/07/2014	56	111726	0	0	0	0	0	0
1406149200	24/07/2014	66	111792	0	0	0	0	0	0
1406235600	25/07/2014	29	111821	0	0	0	0	0	0
1406322000	26/07/2014	83	111904	0	0	0	0	0	0
1406408400	27/07/2014	82	111986	0	0	0	0	0	0
1406494800	28/07/2014	73	112059	0	0	0	0	0	0
1406581200	29/07/2014	45	112104	0	0	0	0	0	0
1406667600	30/07/2014	100	112204	0	0	0	0	0	0
1406754000	31/07/2014	38	112242	0	0	0	0	0	0
1406840400	01/08/2014	83	112325	0	0	0	0	0	0
1406926800	02/08/2014	121	112446	0	0	0	0	0	0
1407013200	03/08/2014	129	112575	0	0	0	0	0	0
1407099600	04/08/2014	94	112669	0	0	0	0	0	0
1407186000	05/08/2014	58	112727	0	0	0	0	0	0
1407272400	06/08/2014	53	112780	0	0	0	0	0	0
1407358800	07/08/2014	49	112829	0	0	0	0	0	0
1407445200	08/08/2014	29	112858	0	0	0	0	0	0
1407531600	09/08/2014	79	112937	0	0	0	0	0	0
1407618000	10/08/2014	64	113001	0	0	0	0	0	0
1407704400	11/08/2014	53	113054	0	0	0	0	0	0
1407790800	12/08/2014	56	113110	0	0	0	0	0	0
1407877200	13/08/2014	89	113199	0	0	0	0	0	0
1407963600	14/08/2014	84	113283	0	0	0	0	0	0
1408050000	15/08/2014	74	113357	0	0	0	0	0	0
1408136400	16/08/2014	57	113414	0	0	0	0	0	0
1408222800	17/08/2014	45	113459	0	0	0	0	0	0
1408309200	18/08/2014	63	113522	0	0	0	0	0	0
1408395600	19/08/2014	53	113575	0	0	0	0	0	0
1408482000	20/08/2014	70	113645	0	0	0	0	0	0
1408568400	21/08/2014	64	113709	0	0	0	0	0	0
1408654800	22/08/2014	46	113755	0	0	0	0	0	0
1408741200	23/08/2014	55	113810	0	0	0	0	0	0
1408827600	24/08/2014	55	113865	0	0	0	0	0	0
1408914000	25/08/2014	84	113949	0	0	0	0	0	0
1409000400	26/08/2014	80	114029	0	0	0	0	0	0
1409086800	27/08/2014	71	114100	0	0	0	0	0	0
1409173200	28/08/2014	92	114192	0	0	0	0	0	0
1409259600	29/08/2014	89	114281	0	0	0	0	0	0
1409346000	30/08/2014	68	114349	0	0	0	0	0	0
1409432400	31/08/2014	117	114466	0	0	0	0	0	0
1409518800	01/09/2014	82	114548	0	0	0	0	0	0
1409605200	02/09/2014	66	114614	0	0	0	0	0	0
1409691600	03/09/2014	68	114682	0	0	0	0	0	0
1409778000	04/09/2014	66	114748	0	0	0	0	0	0
1409864400	05/09/2014	63	114811	0	0	0	0	0	0
1409950800	06/09/2014	150	114961	0	0	0	0	0	0
1410037200	07/09/2014	73	115034	0	0	0	0	0	0
1410123600	08/09/2014	68	115102	0	0	0	0	0	0
1410210000	09/09/2014	110	115212	0	0	0	0	0	0
1410296400	10/09/2014	75	115287	0	0	0	0	0	0
1410382800	11/09/2014	104	115391	0	0	0	0	0	0
1410469200	12/09/2014	133	115524	0	0	0	0	0	0
1410555600	13/09/2014	51	115575	0	0	0	0	0	0
1410642000	14/09/2014	74	115649	0	0	0	0	0	0
1410728400	15/09/2014	150	115799	0	0	0	0	0	0
1410814800	16/09/2014	146	115945	0	0	0	0	0	0
1410901200	17/09/2014	99	116044	0	0	0	0	0	0
1410987600	18/09/2014	122	116166	0	0	0	0	0	0
1411074000	19/09/2014	62	116228	0	0	0	0	0	0
1411160400	20/09/2014	84	116312	0	0	0	0	0	0
1411246800	21/09/2014	103	116415	0	0	0	0	0	0
1411333200	22/09/2014	58	116473	0	0	0	0	0	0
1411419600	23/09/2014	88	116561	0	0	0	0	0	0
1411506000	24/09/2014	48	116609	0	0	0	0	0	0
1411592400	25/09/2014	40	116649	0	0	0	0	0	0
1411678800	26/09/2014	53	116702	0	0	0	0	0	0
1411765200	27/09/2014	36	116738	0	0	0	0	0	0
1411851600	28/09/2014	37	116775	0	0	0	0	0	0
1411938000	29/09/2014	54	116829	0	0	0	0	0	0
1412024400	30/09/2014	37	116866	0	0	0	0	0	0
1412110800	01/10/2014	88	116954	0	0	0	0	0	0
1412197200	02/10/2014	42	116996	0	0	0	0	0	0
1412283600	03/10/2014	74	117070	0	0	0	0	0	0
1412370000	04/10/2014	83	117153	0	0	0	0	0	0
1412456400	05/10/2014	74	117227	0	0	0	0	0	0
1412542800	06/10/2014	67	117294	0	0	0	0	0	0
1412629200	07/10/2014	40	117334	0	0	0	0	0	0
1412715600	08/10/2014	62	117396	0	0	0	0	0	0
1412802000	09/10/2014	57	117453	0	0	0	0	0	0
1412888400	10/10/2014	71	117524	0	0	0	0	0	0
1412974800	11/10/2014	24	117548	0	0	0	0	0	0
1413061200	12/10/2014	49	117597	0	0	0	0	0	0
1413147600	13/10/2014	34	117631	0	0	0	0	0	0
1413234000	14/10/2014	76	117707	0	0	0	0	0	0
1413320400	15/10/2014	61	117768	0	0	0	0	0	0
1413406800	16/10/2014	64	117832	0	0	0	0	0	0
1413493200	17/10/2014	81	117913	0	0	0	0	0	0
1413579600	18/10/2014	45	117958	0	0	0	0	0	0
1413666000	19/10/2014	47	118005	0	0	0	0	0	0
1413752400	20/10/2014	29	118034	0	0	0	0	0	0
1413838800	21/10/2014	93	118127	0	0	0	0	0	0
1413925200	22/10/2014	35	118162	0	0	0	0	0	0
1414011600	23/10/2014	57	118219	0	0	0	0	0	0
1414098000	24/10/2014	46	118265	0	0	0	0	0	0
1414184400	25/10/2014	82	118347	0	0	0	0	0	0
1414270800	26/10/2014	72	118419	0	0	0	0	0	0
1414360800	27/10/2014	65	118484	0	0	0	0	0	0
1414447200	28/10/2014	49	118533	0	0	0	0	0	0
1414533600	29/10/2014	97	118630	0	0	0	0	0	0
1414620000	30/10/2014	91	118721	0	0	0	0	0	0
1414706400	31/10/2014	41	118762	0	0	0	0	0	0
1414792800	01/11/2014	39	118801	0	0	0	0	0	0
1414879200	02/11/2014	94	118895	0	0	0	0	0	0
1414965600	03/11/2014	45	118940	0	0	0	0	0	0
1415052000	04/11/2014	66	119006	0	0	0	0	0	0
1415138400	05/11/2014	91	119097	0	0	0	0	0	0
1415224800	06/11/2014	62	119159	0	0	0	0	0	0
1415311200	07/11/2014	53	119212	0	0	0	0	0	0
1415397600	08/11/2014	40	119252	0	0	0	0	0	0
1415484000	09/11/2014	79	119331	0	0	0	0	0	0
1415570400	10/11/2014	63	119394	0	0	0	0	0	0
1415656800	11/11/2014	82	119476	0	0	0	0	0	0
1415743200	12/11/2014	35	119511	0	0	0	0	0	0
1415829600	13/11/2014	59	119570	0	0	0	0	0	0
1415916000	14/11/2014	42	119612	0	0	0	0	0	0
1416002400	15/11/2014	37	119649	0	0	0	0	0	0
1416088800	16/11/2014	36	119685	0	0	0	0	0	0
1416175200	17/11/2014	40	119725	0	0	0	0	0	0
1416261600	18/11/2014	70	119795	0	0	0	0	0	0
1416348000	19/11/2014	51	119846	0	0	0	0	0	0
1416434400	20/11/2014	83	119929	0	0	0	0	0	0
1416520800	21/11/2014	41	119970	0	0	0	0	0	0
1416607200	22/11/2014	33	120003	0	0	0	0	0	0
1416693600	23/11/2014	32	120035	0	0	0	0	0	0
1416780000	24/11/2014	36	120071	0	0	0	0	0	0
1416866400	25/11/2014	112	120183	0	0	0	0	0	0
1416952800	26/11/2014	25	120208	0	0	0	0	0	0
1417039200	27/11/2014	43	120251	0	0	0	0	0	0
1417125600	28/11/2014	49	120300	0	0	0	0	0	0
1417212000	29/11/2014	57	120357	0	0	0	0	0	0
1417298400	30/11/2014	85	120442	0	0	0	0	0	0
1417384800	01/12/2014	113	120555	0	0	0	0	0	0
1417471200	02/12/2014	41	120596	0	0	0	0	0	0
1417557600	03/12/2014	35	120631	0	0	0	0	0	0
1417644000	04/12/2014	48	120679	0	0	0	0	0	0
1417730400	05/12/2014	58	120737	0	0	0	0	0	0
1417816800	06/12/2014	33	120770	0	0	0	0	0	0
1417903200	07/12/2014	59	120829	0	0	0	0	0	0
1417989600	08/12/2014	56	120885	0	0	0	0	0	0
1418076000	09/12/2014	49	120934	0	0	0	0	0	0
1418162400	10/12/2014	42	120976	0	0	0	0	0	0
1418248800	11/12/2014	49	121025	0	0	0	0	0	0
1418335200	12/12/2014	28	121053	0	0	0	0	0	0
1418421600	13/12/2014	45	121098	0	0	0	0	0	0
1418508000	14/12/2014	54	121152	0	0	0	0	0	0
1418594400	15/12/2014	76	121228	0	0	0	0	0	0
1418680800	16/12/2014	141	121369	0	0	0	0	0	0
1418767200	17/12/2014	65	121434	0	0	0	0	0	0
1418853600	18/12/2014	42	121476	0	0	0	0	0	0
1418940000	19/12/2014	24	121500	0	0	0	0	0	0
1419026400	20/12/2014	51	121551	0	0	0	0	0	0
1419112800	21/12/2014	55	121606	0	0	0	0	0	0
1419199200	22/12/2014	36	121642	0	0	0	0	0	0
1419285600	23/12/2014	81	121723	0	0	0	0	0	0
1419372000	24/12/2014	49	121772	0	0	0	0	0	0
1419458400	25/12/2014	123	121895	0	0	0	0	0	0
1419544800	26/12/2014	61	121956	0	0	0	0	0	0
1419631200	27/12/2014	68	122024	0	0	0	0	0	0
1419717600	28/12/2014	114	122138	0	0	0	0	0	0
1419804000	29/12/2014	34	122172	0	0	0	0	0	0
1419890400	30/12/2014	44	122216	0	0	0	0	0	0
1419976800	31/12/2014	48	122264	0	0	0	0	0	0
1420063200	01/01/2015	49	122313	0	0	0	0	0	0
1420149600	02/01/2015	40	122353	0	0	0	0	0	0
1420236000	03/01/2015	26	122379	0	0	0	0	0	0
1420322400	04/01/2015	31	122410	0	0	0	0	0	0
1420408800	05/01/2015	17	122427	0	0	0	0	0	0
1420495200	06/01/2015	21	122448	0	0	0	0	0	0
1420581600	07/01/2015	12	122460	0	0	0	0	0	0
1420668000	08/01/2015	10	122470	0	0	0	0	0	0
1420754400	09/01/2015	23	122493	0	0	0	0	0	0
1420840800	10/01/2015	45	122538	0	0	0	0	0	0
1420927200	11/01/2015	19	122557	0	0	0	0	0	0
1421013600	12/01/2015	21	122578	0	0	0	0	0	0
1421100000	13/01/2015	21	122599	0	0	0	0	0	0
1421186400	14/01/2015	51	122650	0	0	0	0	0	0
1421272800	15/01/2015	35	122685	0	0	0	0	0	0
1421359200	16/01/2015	28	122713	0	0	0	0	0	0
1421445600	17/01/2015	13	122726	0	0	0	0	0	0
1421532000	18/01/2015	44	122770	0	0	0	0	0	0
1421618400	19/01/2015	44	122814	0	0	0	0	0	0
1421704800	20/01/2015	84	122898	0	0	0	0	0	0
1421791200	21/01/2015	52	122950	0	0	0	0	0	0
1421877600	22/01/2015	37	122987	0	0	0	0	0	0
1421964000	23/01/2015	102	123089	0	0	0	0	0	0
1422050400	24/01/2015	68	123157	0	0	0	0	0	0
1422136800	25/01/2015	84	123241	0	0	0	0	0	0
1422223200	26/01/2015	88	123329	0	0	0	0	0	0
1422309600	27/01/2015	48	123377	0	0	0	0	0	0
1422396000	28/01/2015	42	123419	0	0	0	0	0	0
1422482400	29/01/2015	39	123458	0	0	0	0	0	0
1422568800	30/01/2015	41	123499	0	0	0	0	0	0
1422655200	31/01/2015	38	123537	0	0	0	0	0	0
1422741600	01/02/2015	37	123574	0	0	0	0	0	0
1422828000	02/02/2015	81	123655	0	0	0	0	0	0
1422914400	03/02/2015	38	123693	0	0	0	0	0	0
1423000800	04/02/2015	55	123748	0	0	0	0	0	0
1423087200	05/02/2015	150	123898	0	0	0	0	0	0
1423173600	06/02/2015	102	124000	0	0	0	0	0	0
1423260000	07/02/2015	79	124079	0	0	0	0	0	0
1423346400	08/02/2015	30	124109	0	0	0	0	0	0
1423432800	09/02/2015	76	124185	0	0	0	0	0	0
1423519200	10/02/2015	49	124234	0	0	0	0	0	0
1423605600	11/02/2015	25	124259	0	0	0	0	0	0
1423692000	12/02/2015	9	124268	0	0	0	0	0	0
1423778400	13/02/2015	28	124296	0	0	0	0	0	0
1423864800	14/02/2015	32	124328	0	0	0	0	0	0
1423951200	15/02/2015	44	124372	0	0	0	0	0	0
1424037600	16/02/2015	37	124409	0	0	0	0	0	0
1424124000	17/02/2015	140	124549	0	0	0	0	0	0
1424210400	18/02/2015	69	124618	0	0	0	0	0	0
1424296800	19/02/2015	8	124626	0	0	0	0	0	0
1424383200	20/02/2015	20	124646	0	0	0	0	0	0
1424469600	21/02/2015	83	124729	0	0	0	0	0	0
1424556000	22/02/2015	48	124777	0	0	0	0	0	0
1424642400	23/02/2015	55	124832	0	0	0	0	0	0
1424728800	24/02/2015	50	124882	0	0	0	0	0	0
1424815200	25/02/2015	42	124924	0	0	0	0	0	0
1424901600	26/02/2015	65	124989	0	0	0	0	0	0
1424988000	27/02/2015	57	125046	0	0	0	0	0	0
1425074400	28/02/2015	88	125134	0	0	0	0	0	0
1425160800	01/03/2015	25	125159	0	0	0	0	0	0
1425247200	02/03/2015	54	125213	0	0	0	0	0	0
1425333600	03/03/2015	33	125246	0	0	0	0	0	0
1425420000	04/03/2015	27	125273	0	0	0	0	0	0
1425506400	05/03/2015	91	125364	0	0	0	0	0	0
1425592800	06/03/2015	63	125427	0	0	0	0	0	0
1425679200	07/03/2015	67	125494	0	0	0	0	0	0
1425765600	08/03/2015	79	125573	0	0	0	0	0	0
1425852000	09/03/2015	81	125654	0	0	0	0	0	0
1425938400	10/03/2015	75	125729	0	0	0	0	0	0
1426024800	11/03/2015	80	125809	0	0	0	0	0	0
1426111200	12/03/2015	56	125865	0	0	0	0	0	0
1426197600	13/03/2015	82	125947	0	0	0	0	0	0
1426284000	14/03/2015	98	126045	0	0	0	0	0	0
1426370400	15/03/2015	101	126146	0	0	0	0	0	0
1426456800	16/03/2015	70	126216	0	0	0	0	0	0
1426543200	17/03/2015	85	126301	0	0	0	0	0	0
1426629600	18/03/2015	53	126354	0	0	0	0	0	0
1426716000	19/03/2015	53	126407	0	0	0	0	0	0
1426802400	20/03/2015	163	126570	0	0	0	0	0	0
1426888800	21/03/2015	53	126623	0	0	0	0	0	0
1426975200	22/03/2015	66	126689	0	0	0	0	0	0
1427061600	23/03/2015	61	126750	0	0	0	0	0	0
1427148000	24/03/2015	151	126901	0	0	0	0	0	0
1427234400	25/03/2015	68	126969	0	0	0	0	0	0
1427320800	26/03/2015	127	127096	0	0	0	0	0	0
1427407200	27/03/2015	68	127164	0	0	0	0	0	0
1427493600	28/03/2015	66	127230	0	0	0	0	0	0
1427580000	29/03/2015	57	127287	0	0	0	0	0	0
1427662800	30/03/2015	81	127368	0	0	0	0	0	0
1427749200	31/03/2015	93	127461	0	0	0	0	0	0
1427835600	01/04/2015	59	127520	989	23	966	600	367	22
1427922000	02/04/2015	68	127588	533	530	3	292	17	224
1428008400	03/04/2015	38	127626	1164	545	619	628	122	414
1428094800	04/04/2015	54	127680	978	204	774	640	222	116
1428181200	05/04/2015	83	127763	1105	331	774	727	283	95
1428267600	06/04/2015	72	127835	750	478	272	664	59	27
1428354000	07/04/2015	85	127920	930	649	281	181	532	217
1428440400	08/04/2015	44	127964	681	65	616	364	136	181
1428526800	09/04/2015	18	127982	1252	1162	90	391	389	472
1428613200	10/04/2015	34	128016	1174	122	1052	327	635	212
1428699600	11/04/2015	84	128100	1106	195	911	926	154	26
1428786000	12/04/2015	43	128143	1128	273	855	1067	16	45
1428872400	13/04/2015	72	128215	871	677	194	661	199	11
1428958800	14/04/2015	66	128281	1291	695	596	671	79	541
1429045200	15/04/2015	48	128329	1068	596	472	455	247	366
1429131600	16/04/2015	68	128397	934	160	774	512	76	346
1429218000	17/04/2015	76	128473	1201	981	220	1184	8	9
1429304400	18/04/2015	46	128519	1300	970	330	694	274	332
1429390800	19/04/2015	60	128579	739	571	168	233	377	129
1429477200	20/04/2015	83	128662	870	807	63	461	126	283
1429563600	21/04/2015	48	128710	919	580	339	590	36	293
1429650000	22/04/2015	85	128795	810	556	254	785	17	8
1429736400	23/04/2015	52	128847	980	814	166	493	250	237
1429822800	24/04/2015	56	128903	1185	273	912	217	880	88
1429909200	25/04/2015	56	128959	624	145	479	202	173	249
1429995600	26/04/2015	143	129102	716	122	594	226	8	482
1430082000	27/04/2015	109	129211	668	643	25	141	261	266
1430168400	28/04/2015	47	129258	505	74	431	321	74	110
1430254800	29/04/2015	77	129335	1101	480	621	745	127	229
1430341200	30/04/2015	64	129399	829	803	26	390	127	312
1430427600	01/05/2015	0	129399	1011	628	383	823	120	68
1430514000	02/05/2015	0	129399	573	211	362	259	5	309
1430600400	03/05/2015	0	129399	698	254	444	383	187	128
1430686800	04/05/2015	0	129399	1004	745	259	232	604	168
1430773200	05/05/2015	0	129399	806	469	337	251	22	533
1430859600	06/05/2015	0	129399	1113	849	264	628	277	208
1430946000	07/05/2015	0	129399	608	367	241	69	53	486
1431032400	08/05/2015	0	129399	773	518	255	392	280	101
1431118800	09/05/2015	0	129399	853	508	345	82	89	682
1431205200	10/05/2015	0	129399	573	1	572	230	154	189
1431291600	11/05/2015	0	129399	812	667	145	177	237	398
